chr	start	end	value	pvalue	region_size
chr1	700000	1850000	0.08408365157826089	0.055305755395683456	1150000
chr1	1850000	2300000	-0.06000970149999997	0.10544064748201439	450000
chr1	2300000	2950000	0.06488878352307692	0.008318345323741008	650000
chr1	2950000	3200000	-0.011787365100000002	0.7940647482014388	250000
chr1	3200000	3350000	0.15629173090000004	0.039568345323741004	150000
chr1	3350000	3550000	-0.12098099639999993	0.0739658273381295	200000
chr1	3550000	3850000	0.1547765794	0.04024280575539568	300000
chr1	3950000	4850000	0.0696613022988889	0.03035071942446043	900000
chr1	4850000	5000000	-0.01964560859999999	0.7005395683453237	150000
chr1	5000000	5050000	0.07580893682	0.19649280575539568	50000
chr1	5050000	5300000	-0.03718541345	0.4766187050359712	250000
chr1	5300000	7800000	0.1609409347888	0.003372302158273381	2500000
chr1	7800000	8000000	-0.003055983599999923	0.9357014388489209	200000
chr1	8000000	8450000	0.009090909099999989	0.8304856115107914	450000
chr1	8450000	8900000	-0.002824858800000052	0.9462679856115108	450000
chr1	8900000	8950000	0.02141756539999995	0.6760341726618705	50000
chr1	8950000	9200000	-0.08310220859999995	0.1681654676258993	250000
chr1	9200000	9650000	0.05561262342222216	0.22369604316546762	450000
chr1	9650000	10500000	-0.013689235347058747	0.6184802158273381	850000
chr1	10500000	10550000	0.3414227016000001	0.006519784172661871	50000
chr1	10550000	11050000	-0.06394453	0.2524730215827338	500000
chr1	11050000	12100000	0.08780419205714286	0.05238309352517986	1050000
chr1	12100000	12300000	-0.1289933231	0.06227517985611511	200000
chr1	12300000	13000000	0.1060606060857143	0.01393884892086331	700000
chr1	13100000	13250000	0.1741054614666667	0.012140287769784174	150000
chr1	13750000	13800000	0.1392655368	0.05058453237410072	50000
chr1	13800000	14000000	-0.01610169489999999	0.7466276978417267	200000
chr1	14000000	14150000	0.12614278380000002	0.06587230215827339	150000
chr1	14150000	14600000	-0.009142270159999993	0.8286870503597122	450000
chr1	14600000	14700000	0.12503852078	0.06699640287769784	100000
chr1	14700000	14900000	-0.1113251156	0.09262589928057553	200000
chr1	14900000	16150000	0.12059167948800001	0.009217625899280575	1250000
chr1	16150000	16300000	-0.016178736500000013	0.7459532374100719	150000
chr1	16300000	16750000	0.00636877244444451	0.8235161870503597	450000
chr1	16750000	17100000	-0.08579499597142856	0.01393884892086331	350000
chr1	17100000	17200000	0.019337442300000007	0.7005395683453237	100000
chr1	17200000	17750000	-0.12917308680909095	0.02045863309352518	550000
chr1	17750000	18850000	0.08731264882272727	0.028552158273381294	1100000
chr1	18850000	18900000	-0.02547508989999997	0.6148830935251799	50000
chr1	18900000	19450000	0.08414577207272728	0.1616456834532374	550000
chr1	19450000	19900000	-0.005829481200000042	0.8817446043165468	450000
chr1	19900000	20200000	-0.2638332477333334	0.0035971223021582736	300000
chr1	20200000	20700000	0.031823317899999995	0.3880395683453237	500000
chr1	20700000	21000000	0.21409005306666665	0.006744604316546762	300000
chr1	21000000	22450000	-0.07098985172413794	0.02045863309352518	1450000
chr1	22450000	22700000	0.008808423299999979	0.8365557553956835	250000
chr1	22700000	22750000	-0.06694915250000005	0.2389838129496403	50000
chr1	22750000	23700000	0.030119211763157898	0.16097122302158273	950000
chr1	23700000	24050000	-0.011042629599999909	0.7981115107913669	350000
chr1	24050000	24150000	0.06623009759999998	0.24370503597122303	100000
chr1	24150000	24950000	-0.11975154087500009	0.020233812949640287	800000
chr1	24950000	25400000	0.10843890884444445	0.08745503597122302	450000
chr1	25400000	25600000	-0.017154596899999985	0.7340377697841727	200000
chr1	25650000	25750000	-0.017154596899999985	0.7340377697841727	100000
chr1	25750000	26100000	0.11373908580000003	0.08295863309352518	350000
chr1	26100000	26400000	-0.02891628150000003	0.5611510791366906	300000
chr1	26400000	26500000	0.09381099120000003	0.12657374100719423	100000
chr1	26500000	26550000	-0.1289162815	0.06227517985611511	50000
chr1	26550000	26800000	0.12390857729999993	0.06857014388489209	250000
chr1	26800000	27600000	-0.09377728556875006	0.01843525179856115	800000
chr1	27600000	28000000	0.06436504873749997	0.2448291366906475	400000
chr1	28000000	28450000	-0.03160988415555557	0.1531025179856115	450000
chr1	28450000	29000000	0.005953214781818206	0.5539568345323741	550000
chr1	29000000	29250000	-0.0005392911999999583	0.9862859712230215	250000
chr1	29250000	29900000	0.1068685551384616	0.02045863309352518	650000
chr1	30000000	31150000	0.16235568656956514	0.012140287769784174	1150000
chr1	31150000	31550000	-0.007627118674999989	0.8010341726618705	400000
chr1	31550000	32050000	-0.2281972265	0.007419064748201439	500000
chr1	32050000	32250000	-0.09257832560000001	0.133318345323741	200000
chr1	32250000	32450000	-0.1730868002	0.03169964028776978	200000
chr1	32450000	32700000	0.0009244991999999286	0.9847122302158273	250000
chr1	32700000	33100000	-0.13415511045	0.03035071942446043	400000
chr1	33100000	33950000	0.1336052448235294	0.01393884892086331	850000
chr1	33950000	34150000	-0.048895736999999995	0.3619604316546763	200000
chr1	34150000	35850000	0.09993957520220587	0.010341726618705036	1700000
chr1	35850000	35900000	-0.03140729320000002	0.533498201438849	50000
chr1	35900000	36900000	0.07599640473500002	0.14905575539568344	1000000
chr1	36900000	36950000	0.6897277864	0.0004496402877697842	50000
chr1	36950000	37900000	-0.050131105878947396	0.09869604316546762	950000
chr1	37900000	38250000	0.12653899775714286	0.06227517985611511	350000
chr1	38250000	38500000	0.2203389831	0.015512589928057555	250000
chr1	38500000	38550000	0.51730868	0.0006744604316546763	50000
chr1	38550000	38750000	0.034257832499999974	0.5033723021582733	200000
chr1	38750000	39000000	-0.06866974833999999	0.05642985611510792	250000
chr1	39000000	40050000	0.06767065326666666	0.007419064748201439	1050000
chr1	40050000	40500000	-0.1935028248777778	0.011690647482014389	450000
chr1	40500000	40850000	0.1416098025857143	0.006519784172661871	350000
chr1	40850000	41100000	-0.05059065229999998	0.34757194244604317	250000
chr1	41100000	42950000	0.13547453464324327	0.009217625899280575	1850000
chr1	42950000	43100000	-0.07634822799999996	0.19357014388489208	150000
chr1	43100000	43550000	0.10863721965555556	0.007194244604316547	450000
chr1	43550000	44150000	-0.19087699025000002	0.015737410071942445	600000
chr1	44150000	44550000	0.0496533127875	0.13489208633093525	400000
chr1	44550000	45050000	-0.13458654337999992	0.03169964028776978	500000
chr1	45050000	49650000	0.057466336158021755	0.00539568345323741	4600000
chr1	49650000	50600000	-0.007254075094368422	0.6982913669064749	950000
chr1	50600000	50800000	0.04499229584	0.399955035971223	200000
chr1	50800000	50900000	-0.38379558293	0.0044964028776978415	100000
chr1	50900000	51300000	0.004622496200000048	0.9143435251798561	400000
chr1	51300000	52000000	-0.15338983052857147	0.01955935251798561	700000
chr1	52000000	52350000	0.024645975457142817	0.6184802158273381	350000
chr1	52350000	54550000	-0.1593138628159091	0.00876798561151079	2200000
chr1	54550000	54850000	0.06563088511666666	0.06587230215827339	300000
chr1	54850000	54950000	-0.061016949200000004	0.26888489208633093	100000
chr1	54950000	55300000	0.04201335380000004	0.429181654676259	350000
chr1	55300000	55900000	-0.08353235744166666	0.03035071942446043	600000
chr1	55900000	57000000	-0.32412219265681824	0.0035971223021582736	1100000
chr1	57000000	57300000	-0.1841979113	0.023830935251798562	300000
chr1	57300000	57800000	0.18360297894	0.019784172661870502	500000
chr1	57800000	57850000	-0.055161787399999995	0.31339928057553956	50000
chr1	57850000	58850000	0.054893425789000014	0.07059352517985612	1000000
chr1	58850000	59200000	0.27001981070000003	0.005620503597122302	350000
chr1	59200000	59650000	0.12244478690000005	0.07216726618705036	450000
chr1	59650000	60250000	0.3604605375833334	0.003147482014388489	600000
chr1	60250000	60450000	0.1493579866	0.04136690647482014	200000
chr1	60450000	60750000	0.43613251155499994	0.0015737410071942446	300000
chr1	60750000	61600000	0.020313302516764723	0.554181654676259	850000
chr1	61600000	62550000	-0.08582569672631578	0.06699640287769784	950000
chr1	62550000	63600000	0.16734414357619048	0.01393884892086331	1050000
chr1	63600000	63800000	-0.03045711350000002	0.5413669064748201	200000
chr1	63800000	64700000	0.10738315358888889	0.019784172661870502	900000
chr1	64700000	64750000	-0.6426810477	0.0006744604316546763	50000
chr1	64750000	65300000	-0.2721576317272727	0.009217625899280575	550000
chr1	65300000	65500000	-0.08360939905	0.012140287769784174	200000
chr1	65500000	65700000	0.042193117599999996	0.4282823741007194	200000
chr1	65700000	65750000	-0.10477657939999996	0.10409172661870504	50000
chr1	65750000	66200000	0.02529247273333335	0.3232913669064748	450000
chr1	66200000	66400000	0.23289676419999994	0.013039568345323741	200000
chr1	66400000	66450000	0.11566512579999999	0.07756294964028777	50000
chr1	66450000	66700000	0.39884437594	0.0006744604316546763	250000
chr1	66700000	67200000	0.045197740099999995	0.399955035971223	500000
chr1	67200000	67800000	-0.11926040064166667	0.015512589928057555	600000
chr1	67800000	68000000	0.059193631299999994	0.2819244604316547	200000
chr1	68000000	68050000	-0.09989727780000002	0.11623201438848921	50000
chr1	68050000	68300000	0.0046224961999999925	0.9143435251798561	250000
chr1	68300000	68600000	-0.009809964000000004	0.8192446043165468	300000
chr1	68600000	68850000	0.0848228043	0.1618705035971223	250000
chr1	68850000	69900000	-0.007883923984000002	0.8500449640287769	1050000
chr1	69900000	70900000	0.20249101179499998	0.007194244604316547	1000000
chr1	70900000	71450000	-0.03495354156909091	0.09937050359712231	550000
chr1	71450000	71600000	0.024165382600000007	0.6344424460431655	150000
chr1	71600000	72350000	-0.05927580895200001	0.01393884892086331	750000
chr1	72350000	72850000	0.021890087330000012	0.06025179856115108	500000
chr1	72850000	73150000	-0.178749357975	0.0085431654676259	300000
chr1	73150000	74550000	0.025974943136428567	0.45818345323741005	1400000
chr1	74550000	74950000	-0.06434257834875001	0.07419064748201439	400000
chr1	74950000	75250000	0.19568995036000003	0.005620503597122302	300000
chr1	75250000	76150000	-0.030124693258777775	0.5391187050359713	900000
chr1	76150000	76650000	0.0917334360383	0.02045863309352518	500000
chr1	76650000	77250000	-0.0020287621980000004	0.960431654676259	600000
chr1	77250000	77300000	0.048818695429	0.3619604316546763	50000
chr1	77300000	77900000	-0.11151771959000001	0.04024280575539568	600000
chr1	77900000	78400000	0.07372881355999991	0.1875	500000
chr1	78400000	79800000	-0.11563577666428575	0.006519784172661871	1400000
chr1	79800000	79850000	0.006548536299999963	0.864658273381295	50000
chr1	79850000	82300000	-0.2985587455379592	0.0011241007194244604	2450000
chr1	82300000	82450000	0.1130200308	0.08655575539568346	150000
chr1	82450000	82500000	-0.1807652799	0.02585431654676259	50000
chr1	82500000	82700000	0.03590138675	0.491681654676259	200000
chr1	82700000	83050000	-0.029719715311428568	0.5391187050359713	350000
chr1	83050000	83450000	0.032973805829999994	0.5191097122302158	400000
chr1	83450000	84350000	-0.05898248016333333	0.0035971223021582736	900000
chr1	84350000	85200000	0.12254901959411763	0.01843525179856115	850000
chr1	85200000	85700000	-0.12334103749000003	0.06115107913669065	500000
chr1	85700000	86100000	0.06802773500000003	0.23516187050359713	400000
chr1	86100000	86150000	0.5407550077000001	0.0006744604316546763	50000
chr1	86150000	86400000	0.006856702600000042	0.8617356115107914	250000
chr1	86400000	86800000	-0.045300462199999975	0.3983812949640288	400000
chr1	86800000	87000000	0.06391884949999999	0.2524730215827338	200000
chr1	87000000	87150000	-0.015331278899999995	0.752248201438849	150000
chr1	87150000	87850000	0.1433193924857143	0.015512589928057555	700000
chr1	87850000	88550000	-0.11850282485	0.015737410071942445	700000
chr1	88550000	90250000	0.10812939968852942	0.005620503597122302	1700000
chr1	90250000	90300000	-0.17134052389999999	0.03214928057553957	50000
chr1	90300000	90500000	0.15210580380000005	0.040467625899280574	200000
chr1	90500000	90800000	-0.038084232110000005	0.4691996402877698	300000
chr1	90800000	90900000	0.0878274269	0.1531025179856115	100000
chr1	90900000	91350000	-0.03872624550111111	0.03169964028776978	450000
chr1	91350000	91500000	0.04411915770000002	0.4051258992805755	150000
chr1	91500000	91550000	0.2880585516	0.00876798561151079	50000
chr1	91550000	91950000	-0.007139188500000004	0.8585881294964028	400000
chr1	91950000	92350000	0.23310220849999996	0.013039568345323741	400000
chr1	92350000	92400000	-0.09740626610000003	0.11870503597122302	50000
chr1	92400000	92750000	0.04501797630000004	0.399955035971223	350000
chr1	92750000	94000000	-0.06108782742800003	0.07419064748201439	1250000
chr1	94000000	94300000	0.06091422708333331	0.26169064748201437	300000
chr1	94300000	94500000	-0.17005649720000005	0.03214928057553957	200000
chr1	94500000	94800000	0.00017976379999995462	0.9912320143884892	300000
chr1	94800000	95000000	-0.1874422188	0.023830935251798562	200000
chr1	95000000	96450000	0.021275879778620707	0.3657823741007194	1450000
chr1	96450000	96700000	-0.16802773499999998	0.03237410071942446	250000
chr1	96700000	97300000	0.089635764475	0.04428956834532374	600000
chr1	97300000	97550000	-0.06398048277999994	0.01821043165467626	250000
chr1	97550000	98550000	0.08649589104499997	0.040467625899280574	1000000
chr1	98550000	99100000	-0.10099920628181819	0.04428956834532374	550000
chr1	99100000	99500000	0.07491011810000002	0.021133093525179857	400000
chr1	99500000	100300000	-0.09344343859249998	0.049910071942446045	800000
chr1	100300000	101000000	0.047630053542857154	0.015512589928057555	700000
chr1	101000000	101050000	-0.10721623010000003	0.09802158273381295	50000
chr1	101050000	101500000	0.15057923873333337	0.007194244604316547	450000
chr1	101500000	101800000	-0.15225988700000004	0.04024280575539568	300000
chr1	101800000	101850000	0.250770416	0.011690647482014389	50000
chr1	101850000	102550000	-0.00487930149	0.9028776978417267	700000
chr1	102550000	103000000	0.018375848893333338	0.5310251798561151	450000
chr1	103000000	103800000	-0.05099993579124999	0.01393884892086331	800000
chr1	103900000	103950000	-0.003646635799999992	0.9262589928057554	50000
chr1	104000000	104200000	0.0344761171275	0.4806654676258993	200000
chr1	104250000	104600000	0.02835130971	0.5739658273381295	350000
chr1	104600000	105200000	-0.015551703469166662	0.7466276978417267	600000
chr1	105200000	106350000	-0.31189678658608705	0.003372302158273381	1150000
chr1	106350000	107050000	-0.00921931176	0.8286870503597122	700000
chr1	107050000	107150000	-0.13952234204	0.05058453237410072	100000
chr1	107150000	107450000	-0.025115562399999986	0.6200539568345323	300000
chr1	107450000	108050000	0.21713747645	0.01079136690647482	600000
chr1	108050000	108300000	-0.03926553672000001	0.458408273381295	250000
chr1	108300000	108650000	0.07490644951	0.11870503597122302	350000
chr1	108650000	108700000	-0.05875706210000001	0.2879946043165468	50000
chr1	108700000	108800000	0.22796610169999998	0.01393884892086331	100000
chr1	108850000	108950000	0.025988700599999998	0.6112859712230215	100000
chr1	109000000	109050000	0.32683615819999995	0.006744604316546762	50000
chr1	109050000	109300000	0.007139188499999949	0.8585881294964028	250000
chr1	109300000	109550000	0.3206985105	0.006744604316546762	250000
chr1	109550000	109950000	0.0659411915625	0.23246402877697842	400000
chr1	109950000	110050000	0.1927837699	0.021133093525179857	100000
chr1	110050000	110600000	0.022979408899999994	0.6285971223021583	550000
chr1	110600000	111050000	-0.0984334874222222	0.03237410071942446	450000
chr1	111050000	111150000	0.29892141759	0.007419064748201439	100000
chr1	111150000	111650000	-0.073086800215	0.1076888489208633	500000
chr1	111650000	112000000	0.07891628149999998	0.18142985611510792	350000
chr1	112000000	112300000	0.40038520799999994	0.003147482014388489	300000
chr1	112300000	112600000	0.0328197227	0.5200089928057554	300000
chr1	112600000	112900000	-0.012711864399999995	0.7839478417266187	300000
chr1	112900000	113250000	0.23967642528571428	0.011915467625899281	350000
chr1	113250000	113900000	-0.09462881749230771	0.12320143884892086	650000
chr1	113900000	115350000	0.16152347554482757	0.0006744604316546763	1450000
chr1	115350000	115900000	-0.07637624317999997	0.07419064748201439	550000
chr1	115900000	116050000	-0.3770416025	0.0044964028776978415	150000
chr1	116050000	116300000	0.07144324600000002	0.22144784172661872	250000
chr1	116300000	116650000	-0.03683689192714285	0.021133093525179857	350000
chr1	116650000	116900000	0.0038777607000000103	0.9262589928057554	250000
chr1	116900000	117450000	0.3143810991272727	0.006519784172661871	550000
chr1	117450000	118100000	0.08780372171538463	0.07419064748201439	650000
chr1	118100000	118250000	-0.01548536210000001	0.7513489208633094	150000
chr1	118250000	118500000	0.1660246533	0.03237410071942446	250000
chr1	118500000	118700000	-0.07894196197	0.18142985611510792	200000
chr1	118700000	118850000	0.036209553154	0.48763489208633093	150000
chr1	118850000	119450000	-0.007575757576	0.85431654676259	600000
chr1	119450000	119850000	0.06336350793750001	0.24775179856115107	400000
chr1	119850000	120100000	-0.028531073399999995	0.5699190647482014	250000
chr1	120100000	120150000	0.4248587571	0.0024730215827338128	50000
chr1	120150000	120450000	-0.13044427319999996	0.06025179856115108	300000
chr1	120450000	120700000	0.08353877760000006	0.16749100719424462	250000
chr1	120750000	120950000	0.06189008735000004	0.16749100719424462	200000
chr1	121100000	121400000	0.04024139710000002	0.4455935251798561	300000
chr1	121450000	121500000	0.04024139710000002	0.4455935251798561	50000
chr1	142500000	142550000	-0.001425269600000001	0.9799910071942446	50000
chr1	142600000	142650000	-0.001425269600000001	0.9799910071942446	50000
chr1	143100000	143300000	-0.007524396500000002	0.8570143884892086	200000
chr1	143500000	143550000	-0.007524396500000002	0.8570143884892086	50000
chr1	143950000	144100000	0.16176168459999996	0.03597122302158273	150000
chr1	144500000	144750000	0.08781458647999998	0.012140287769784174	250000
chr1	144800000	145100000	0.04355418590000004	0.4120953237410072	300000
chr1	145100000	145300000	-0.13746789930000003	0.05238309352517986	200000
chr1	145350000	145400000	-0.13746789930000003	0.05238309352517986	50000
chr1	145400000	145850000	0.0030688237999999535	0.9339028776978417	450000
chr1	146300000	146400000	0.08900873130000003	0.1474820143884892	100000
chr1	146450000	147450000	0.08798600409499999	0.008318345323741008	1000000
chr1	147700000	147850000	0.09021571649999999	0.14163669064748202	150000
chr1	148000000	148050000	0.008577298399999989	0.8403776978417267	50000
chr1	148200000	148250000	0.008577298399999989	0.8403776978417267	50000
chr1	148500000	148600000	-0.2532742681	0.011690647482014389	100000
chr1	148800000	148950000	0.01718027729999999	0.7340377697841727	150000
chr1	149000000	149400000	0.01718027729999999	0.7340377697841727	400000
chr1	149650000	150200000	0.003964140654545453	0.7340377697841727	550000
chr1	150200000	152000000	-0.09464988872500005	0.02922661870503597	1800000
chr1	152000000	153250000	0.09975346687360002	0.008318345323741008	1250000
chr1	153250000	153450000	-0.018567026200000003	0.7185251798561151	200000
chr1	153450000	153500000	0.5506420133	0.0006744604316546763	50000
chr1	153500000	153700000	0.11124807389999991	0.09262589928057553	200000
chr1	153700000	153950000	-0.02218798148000003	0.5256294964028777	250000
chr1	153950000	154000000	0.2721879815	0.009217625899280575	50000
chr1	154000000	154600000	-0.08044213314999998	0.10544064748201439	600000
chr1	154600000	154650000	0.12236774530000005	0.07216726618705036	50000
chr1	154650000	154900000	-0.12198253719999996	0.07284172661870504	250000
chr1	154900000	155800000	0.05972150884999999	0.11982913669064749	900000
chr1	155800000	156300000	-0.08145865431999995	0.09869604316546762	500000
chr1	156300000	156900000	0.028561034050000017	0.5413669064748201	600000
chr1	156900000	157150000	-0.033025166900000014	0.5182104316546763	250000
chr1	157150000	157900000	0.011816469816000005	0.6940197841726619	750000
chr1	157900000	157950000	0.50909090906	0.0006744604316546763	50000
chr1	157950000	158700000	-0.008561890091999992	0.4691996402877698	750000
chr1	158700000	160600000	0.09965736761131576	0.007419064748201439	1900000
chr1	160600000	160650000	-0.009270672899999999	0.827113309352518	50000
chr1	160650000	161500000	0.02217740711764705	0.4613309352517986	850000
chr1	161500000	161650000	-0.045043656900000006	0.399955035971223	150000
chr1	161650000	162500000	0.03631529650000004	0.2819244604316547	850000
chr1	162500000	163300000	-0.00884854904374998	0.8322841726618705	800000
chr1	163300000	163350000	0.6760400617	0.0004496402877697842	50000
chr1	163350000	163550000	-0.15870570104	0.03866906474820144	200000
chr1	163550000	164500000	0.01201038033736842	0.49235611510791366	950000
chr1	164500000	164800000	-0.08330765279999996	0.1681654676258993	300000
chr1	164800000	167400000	0.12095482200653848	0.0006744604316546763	2600000
chr1	167400000	167900000	-0.022598870099999974	0.6344424460431655	500000
chr1	167900000	168250000	0.07467899330000005	0.2014388489208633	350000
chr1	168250000	168300000	-0.1597842835	0.03776978417266187	50000
chr1	168300000	168500000	0.14930662559999996	0.04136690647482014	200000
chr1	168500000	168550000	-0.1769645609	0.028552158273381294	50000
chr1	168550000	169500000	0.1167315438157895	0.03597122302158273	950000
chr1	169500000	169550000	-0.1530559836	0.04024280575539568	50000
chr1	169550000	170050000	0.04465331271999999	0.24213129496402877	500000
chr1	170050000	170450000	-0.05430148950000002	0.11870503597122302	400000
chr1	170450000	171550000	0.08470724192272727	0.040467625899280574	1100000
chr1	171550000	172000000	-0.2181190435333333	0.0011241007194244604	450000
chr1	172000000	172350000	0.07845403179999999	0.1845773381294964	350000
chr1	172350000	173150000	-0.0606333462125	0.01393884892086331	800000
chr1	173150000	173300000	0.12051874679999997	0.07419064748201439	150000
chr1	173300000	173450000	-0.048972778600000044	0.3619604316546763	150000
chr1	173450000	173500000	0.111633282	0.09262589928057553	50000
chr1	173500000	173750000	-0.16661530559999999	0.03237410071942446	250000
chr1	173750000	174650000	0.07655224559999997	0.03866906474820144	900000
chr1	174650000	174700000	-0.16420133539999998	0.03282374100719424	50000
chr1	174700000	176200000	0.13173258003033336	0.006070143884892087	1500000
chr1	176200000	176250000	-0.10891114530000001	0.09577338129496403	50000
chr1	176250000	177100000	0.10545031573058823	0.01821043165467626	850000
chr1	177100000	177150000	-0.04902413969999998	0.3612859712230216	50000
chr1	177150000	177300000	0.20521314840000002	0.01955935251798561	150000
chr1	177300000	177350000	0.30824345142	0.007419064748201439	50000
chr1	177350000	177750000	0.10626605032	0.09869604316546762	400000
chr1	177750000	177900000	0.46219825372	0.0011241007194244604	150000
chr1	177900000	177950000	-0.21204417050000002	0.01821043165467626	50000
chr1	177950000	179800000	0.11470314690810818	0.007419064748201439	1850000
chr1	179800000	180200000	-0.06556882384999999	0.06857014388489209	400000
chr1	180200000	180250000	0.050410888500000084	0.3527428057553957	50000
chr1	180250000	180600000	-0.06723530708571426	0.09667266187050359	350000
chr1	180600000	180850000	0.06874679	0.23381294964028776	250000
chr1	180850000	180950000	0.30172059580000005	0.007419064748201439	100000
chr1	180950000	182050000	0.04462576454136364	0.1681654676258993	1100000
chr1	182050000	182400000	0.40136840565	0.0017985611510791368	350000
chr1	182400000	182550000	0.0767847971	0.1931205035971223	150000
chr1	182550000	183650000	-0.07485408790454545	0.012589928057553957	1100000
chr1	183650000	184650000	0.048714689315000025	0.26888489208633093	1000000
chr1	184650000	185200000	-0.02617079888181816	0.47347122302158273	550000
chr1	185200000	185550000	0.010195172099999983	0.8118255395683454	350000
chr1	185550000	186350000	-0.17185894968750004	0.00876798561151079	800000
chr1	186350000	186400000	0.03148433490000002	0.5325989208633094	50000
chr1	186400000	187900000	-0.42123095356866685	0.0008992805755395684	1500000
chr1	187900000	189350000	-0.17951667463793106	0.01843525179856115	1450000
chr1	189350000	189450000	-0.2820749872	0.00876798561151079	100000
chr1	189450000	189900000	-0.24676425270000005	0.012140287769784174	450000
chr1	189900000	190000000	-0.30130970720000005	0.007419064748201439	100000
chr1	190000000	190750000	-0.23050333850000007	0.012365107913669064	750000
chr1	190750000	190800000	-0.2743965075	0.00876798561151079	50000
chr1	190800000	192100000	-0.1887697048807692	0.0170863309352518	1300000
chr1	192100000	192200000	-0.3012069851	0.007419064748201439	100000
chr1	192200000	192450000	-0.12324088340000006	0.06901978417266187	250000
chr1	192450000	192600000	0.05850025680000004	0.29069244604316546	150000
chr1	192600000	193100000	-0.17822290705999996	0.01393884892086331	500000
chr1	193100000	193200000	0.031587056999999974	0.53125	100000
chr1	193200000	193400000	-0.2833846944	0.00876798561151079	200000
chr1	193400000	195150000	-0.46745615967028575	0.0006744604316546763	1750000
chr1	195150000	195700000	-0.23920717186363633	0.007419064748201439	550000
chr1	195700000	196100000	-0.37373523371249995	0.0015737410071942446	400000
chr1	196100000	197000000	-0.13498687442777776	0.009217625899280575	900000
chr1	197000000	197050000	0.014432460099999989	0.7553956834532374	50000
chr1	197050000	197200000	-0.1249614792	0.06699640287769784	150000
chr1	197200000	197650000	-0.2402813445111111	0.007419064748201439	450000
chr1	197650000	198050000	-0.017620056512500037	0.7185251798561151	400000
chr1	198050000	198250000	0.0664355419	0.24190647482014388	200000
chr1	198250000	198950000	-0.04941485069285715	0.05170863309352518	700000
chr1	198950000	199150000	-0.187596302	0.023830935251798562	200000
chr1	199150000	199300000	-0.09088341040000003	0.13534172661870503	150000
chr1	199300000	199350000	-0.23071391890000004	0.01393884892086331	50000
chr1	199350000	199550000	-0.12768361579999998	0.0651978417266187	200000
chr1	199550000	200250000	-0.2665749505142857	0.00876798561151079	700000
chr1	200250000	201100000	0.02312456571176472	0.5611510791366906	850000
chr1	201100000	201400000	-0.14748330759999995	0.041591726618705034	300000
chr1	201400000	201800000	0.10382639958750002	0.03866906474820144	400000
chr1	201800000	202650000	-0.1519532312	0.010341726618705036	850000
chr1	202650000	203000000	0.028949299214285747	0.2306654676258993	350000
chr1	203000000	204500000	-0.11273326488666667	0.01393884892086331	1500000
chr1	204500000	205300000	0.06350475089374996	0.011915467625899281	800000
chr1	205300000	205950000	-0.16744004580769234	0.006744604316546762	650000
chr1	206100000	206350000	0.032365177240000056	0.22144784172661872	250000
chr1	206450000	206950000	0.06789162817999997	0.00876798561151079	500000
chr1	206950000	207900000	-0.12518043954210528	0.006519784172661871	950000
chr1	207900000	209450000	0.1326573553619355	0.007419064748201439	1550000
chr1	209450000	209750000	-0.009167950700000038	0.8286870503597122	300000
chr1	209750000	211400000	0.1160713451909091	0.0085431654676259	1650000
chr1	211400000	211700000	-0.046250642000000064	0.3846672661870504	300000
chr1	211700000	212150000	-0.22993494270000003	0.00876798561151079	450000
chr1	212150000	212550000	-0.03135593219999999	0.533498201438849	400000
chr1	212550000	213450000	0.10461678936666667	0.039568345323741004	900000
chr1	213450000	213500000	-0.23394966619999996	0.013039568345323741	50000
chr1	213500000	214150000	0.01302003081	0.7781025179856115	650000
chr1	214150000	214450000	0.16556240370999997	0.03237410071942446	300000
chr1	214450000	214500000	0.75172059581	0.0002248201438848921	50000
chr1	214500000	214700000	-0.13312788900000005	0.05732913669064748	200000
chr1	214700000	214800000	-0.3449922958	0.006070143884892087	100000
chr1	214800000	215400000	-0.15881484334999998	0.015512589928057555	600000
chr1	215400000	216350000	-0.3565796231631579	0.0013489208633093526	950000
chr1	216350000	217000000	-0.10553909362307697	0.0397931654676259	650000
chr1	217000000	217200000	0.16566512590000002	0.03237410071942446	200000
chr1	217200000	217650000	-0.06579067513333334	0.1845773381294964	450000
chr1	217650000	217850000	0.0	0.997751798561151	200000
chr1	217850000	218450000	-0.3189265536666666	0.0044964028776978415	600000
chr1	218450000	218500000	0.16779661010000002	0.03237410071942446	50000
chr1	218500000	219800000	-0.30425407927692305	0.00539568345323741	1300000
chr1	219800000	220000000	-0.14229583979999993	0.048561151079136694	200000
chr1	220000000	220150000	-0.2837442218999999	0.00876798561151079	150000
chr1	220150000	220900000	-0.06654168801999998	0.11308453237410072	750000
chr1	220900000	221350000	-0.20081607027777781	0.015512589928057555	450000
chr1	221350000	221600000	-0.1036466359	0.10544064748201439	250000
chr1	221600000	221850000	-0.19874165380000003	0.02045863309352518	250000
chr1	221850000	222550000	-0.05763812455714288	0.08992805755395683	700000
chr1	222550000	222600000	-0.1730097586	0.03169964028776978	50000
chr1	222600000	222700000	-0.009373395000000007	0.8223920863309353	100000
chr1	222700000	222750000	-0.2730097586	0.009217625899280575	50000
chr1	222750000	223200000	-0.05027107226666667	0.14995503597122303	450000
chr1	223200000	223650000	0.08235747310000002	0.17153776978417265	450000
chr1	223650000	223850000	-0.008243451499999999	0.8419514388489209	200000
chr1	223850000	223900000	0.28554185919999997	0.00876798561151079	50000
chr1	223900000	224050000	-0.08263995889999998	0.17086330935251798	150000
chr1	224050000	224100000	0.10220852589999996	0.1076888489208633	50000
chr1	224100000	224650000	-0.08757295602727266	0.04428956834532374	550000
chr1	224650000	225150000	0.08546481770000003	0.16097122302158273	500000
chr1	225150000	225550000	-0.143605547	0.046987410071942445	400000
chr1	225550000	225600000	0.38888032869999994	0.0035971223021582736	50000
chr1	225600000	226300000	-0.12695355490714286	0.014838129496402877	700000
chr1	226300000	226500000	0.2505649717499999	0.006744604316546762	200000
chr1	226500000	227200000	0.07875486090000003	0.11982913669064749	700000
chr1	227200000	227600000	0.28202362599999997	0.00876798561151079	400000
chr1	227600000	227650000	-0.11063174119999997	0.09307553956834533	50000
chr1	227650000	231750000	0.16133482406182928	0.0006744604316546763	4100000
chr1	231750000	232700000	-0.11325521041578948	0.015512589928057555	950000
chr1	232700000	233500000	0.07597265026250001	0.00876798561151079	800000
chr1	233500000	233550000	-0.0403954802	0.44469424460431656	50000
chr1	233550000	234600000	0.1348203585380953	0.012140287769784174	1050000
chr1	234600000	235300000	-0.1284338542928571	0.03214928057553957	700000
chr1	235300000	235650000	0.009578839200000022	0.8194694244604317	350000
chr1	235650000	235850000	-0.0669491526	0.2389838129496403	200000
chr1	235850000	238000000	0.09935141722139533	0.00876798561151079	2150000
chr1	238000000	239150000	-0.0733201580826087	0.021133093525179857	1150000
chr1	239150000	239900000	-0.40164013014000005	0.0024730215827338128	750000
chr1	239900000	240150000	-0.1881869543	0.023830935251798562	250000
chr1	240150000	240200000	0.00672830000000002	0.8617356115107914	50000
chr1	240200000	240600000	-0.12664355416249998	0.02045863309352518	400000
chr1	240600000	240800000	0.2818181818	0.00876798561151079	200000
chr1	240800000	241300000	-0.07409861324	0.03214928057553957	500000
chr1	241300000	241650000	0.02865947609999997	0.5656474820143885	350000
chr1	241650000	242050000	-0.16910631740000004	0.024280575539568347	400000
chr1	242050000	242200000	0.43654340008	0.0013489208633093526	150000
chr1	242200000	242400000	0.11592193117999999	0.07756294964028777	200000
chr1	242400000	243250000	0.024538505695294116	0.6088129496402878	850000
chr1	243250000	243300000	0.65326142787	0.0004496402877697842	50000
chr1	243300000	243600000	-0.11492039030000001	0.0798111510791367	300000
chr1	243600000	243800000	0.06705187470000007	0.2389838129496403	200000
chr1	243800000	244150000	-0.06931176169999997	0.2306654676258993	350000
chr1	244150000	244450000	-0.4012326657000001	0.002922661870503597	300000
chr1	244450000	244600000	-0.18513097069999995	0.023830935251798562	150000
chr1	244600000	247000000	0.1315565613854167	0.007194244604316547	2400000
chr1	247000000	247100000	-0.042706728299999996	0.42131294964028776	100000
chr1	247100000	247450000	0.1482023626	0.041591726618705034	350000
chr1	247450000	247650000	0.4502054442825	0.0006744604316546763	200000
chr1	247650000	248000000	0.2799435028300001	0.00876798561151079	350000
chr1	248000000	248400000	0.7135593220299999	0.0002248201438848921	400000
chr1	248400000	248600000	0.28418079093	0.00876798561151079	200000
chr1	248600000	248950000	0.08399552428571426	0.06587230215827339	350000
chr1	249050000	249250000	0.07814586545000002	0.06587230215827339	200000
chr10	50000	600000	-0.02186497070000002	0.47765254566653714	550000
chr10	600000	750000	0.042596663633333254	0.2891566265060241	150000
chr10	750000	1150000	-0.015970515899999982	0.7100660707345511	400000
chr10	1150000	1750000	0.06754385965833333	0.1356393315196269	600000
chr10	1750000	2050000	-0.039281865599999986	0.1919937815779246	300000
chr10	2050000	2450000	0.044979309462500006	0.22036533229692964	400000
chr10	2450000	2850000	-0.0013836802999999953	0.9774582199766809	400000
chr10	2850000	3100000	-0.2635458425	0.008550330353672756	250000
chr10	3100000	3600000	0.1756110176300001	0.020209871745044693	500000
chr10	3600000	3800000	-0.04981249192499995	0.07306645938593082	200000
chr10	3800000	4850000	0.16557733399523814	0.014380101049358725	1050000
chr10	4850000	5700000	-0.17520785632941177	0.013602798289933929	850000
chr10	5700000	6450000	0.08947627050000001	0.03653322969296541	750000
chr10	6450000	6550000	-0.11587999480000002	0.09988340458608629	100000
chr10	6550000	6850000	0.0381740592	0.4372328021764477	300000
chr10	6850000	7500000	-0.0229814282623077	0.16439953361834433	650000
chr10	7500000	8600000	0.08563711600909092	0.004275165176836378	1100000
chr10	8600000	9200000	-0.00583861365833335	0.6673144189661874	600000
chr10	9200000	9250000	0.0409672831	0.3983676642052079	50000
chr10	9250000	10550000	-0.04384903861538461	0.1379712397979013	1300000
chr10	10550000	11700000	0.035189672717391304	0.2289156626506024	1150000
chr10	11700000	12000000	-0.1388077072	0.07306645938593082	300000
chr10	12000000	13350000	0.13406468672222221	0.003109211037699184	1350000
chr10	13350000	13700000	-0.06593633958571431	0.22036533229692964	350000
chr10	13700000	14150000	0.07725764036666664	0.03653322969296541	450000
chr10	14150000	15750000	-0.11489840617500001	0.006607073455110766	1600000
chr10	15750000	17800000	0.05947775291951221	0.010104935872522347	2050000
chr10	18200000	18550000	0.017871460000000006	0.6898561989895065	350000
chr10	18550000	18800000	-0.053937669700000024	0.28721336960746213	250000
chr10	18800000	19000000	0.011211690100000005	0.7901282549553051	200000
chr10	19000000	20550000	-0.05621654992258062	0.17800233190827827	1550000
chr10	20550000	21000000	0.023735218488888894	0.39992226972405753	450000
chr10	21000000	21100000	-0.002935471299999992	0.9459774582199767	100000
chr10	21100000	21350000	0.02338031810000002	0.6354450058297707	250000
chr10	21350000	21550000	-0.11175481709999999	0.10338126700349787	200000
chr10	21550000	22300000	0.04837708520000003	0.20171006607073455	750000
chr10	22300000	22850000	-0.034878854554545466	0.18344345122425185	550000
chr10	22850000	23050000	0.03671278929999999	0.45394481150408084	200000
chr10	23050000	23150000	-0.17065821799999997	0.04391760590750097	100000
chr10	23150000	23600000	0.09211029208888888	0.026428293820443063	450000
chr10	23600000	24000000	0.6091038406375	0.000388651379712398	400000
chr10	24000000	24450000	0.2557480926	0.010104935872522347	450000
chr10	24450000	24900000	0.12912912907777777	0.06723668869024485	450000
chr10	24900000	24950000	0.2165912323	0.015157403808783521	50000
chr10	24950000	25300000	0.03718756349999995	0.43684415079673533	350000
chr10	25300000	25400000	0.69527996893	0.000388651379712398	100000
chr10	25400000	26200000	0.05861728956874999	0.2289156626506024	800000
chr10	26200000	26600000	-0.02468640889000001	0.6117372716673144	400000
chr10	26600000	27550000	0.032228249410526294	0.25301204819277107	950000
chr10	27550000	27750000	-0.06892538470000004	0.2118150019432569	200000
chr10	27750000	28250000	0.017890857389999997	0.6820831713952584	500000
chr10	28250000	28450000	-0.04612698819999994	0.3548387096774194	200000
chr10	28450000	28800000	0.1214405794	0.09288767975126312	350000
chr10	28800000	28950000	-0.15039441359999994	0.06412747765254567	150000
chr10	28950000	29700000	-0.49187982242	0.000388651379712398	750000
chr10	29700000	30150000	-0.0005301952999999804	0.9879518072289156	450000
chr10	30150000	30300000	0.33730764260000007	0.00388651379712398	150000
chr10	30300000	31150000	-0.14968545805294114	0.04003109211037699	850000
chr10	31150000	32350000	0.04892829432499996	0.10921103769918383	1200000
chr10	32350000	32750000	-0.22597956805000002	0.010104935872522347	400000
chr10	32750000	33700000	0.03599338447368422	0.15584920326467158	950000
chr10	33700000	34250000	-0.059149101263636414	0.25612125923047024	550000
chr10	34250000	34950000	0.04226598435714281	0.10726778080062184	700000
chr10	34950000	35350000	-0.10454545452500005	0.03381267003497863	400000
chr10	35350000	35400000	0.017561101799999923	0.6921881072677808	50000
chr10	35400000	35600000	-0.035070477200000005	0.4764865915273999	200000
chr10	35600000	35900000	0.07896029999999998	0.17022930431403033	300000
chr10	35900000	36350000	-0.06960932222222226	0.1379712397979013	450000
chr10	36350000	36700000	0.0006465796000000301	0.9879518072289156	350000
chr10	36700000	36750000	-0.023677744699999947	0.624951418577536	50000
chr10	36750000	37100000	0.1055088582	0.10921103769918383	350000
chr10	37100000	37200000	-0.2892279839	0.006995724834823164	100000
chr10	37200000	38400000	0.046531100489166664	0.018655266226195105	1200000
chr10	38400000	38600000	-0.027221000900000014	0.5806451612903226	200000
chr10	38600000	39150000	0.015623714218181822	0.5709288767975126	550000
chr10	42350000	42550000	0.017612828199999986	0.6921881072677808	200000
chr10	42600000	42950000	-0.0476399845	0.34045860862806065	350000
chr10	42950000	43250000	0.01749213321666668	0.11232024873688301	300000
chr10	43250000	43550000	-0.043579464600000006	0.3742712786630393	300000
chr10	43550000	43600000	0.21479374110000005	0.017100660707345512	50000
chr10	43600000	43850000	-0.09601706970000001	0.12942090944422852	250000
chr10	43850000	44900000	0.20435363588095234	0.006995724834823164	1050000
chr10	44900000	45200000	-0.08099271524999996	0.054411193159735714	300000
chr10	45200000	45300000	0.00046553739999999344	0.9879518072289156	100000
chr10	45300000	45950000	-0.0478140636230769	0.2491255343956471	650000
chr10	45950000	46300000	0.07012617535714284	0.12942090944422852	350000
chr10	46900000	47150000	-0.1930686668	0.024096385542168676	250000
chr10	47500000	47750000	-0.12251390150000004	0.07539836766420521	250000
chr10	47950000	48000000	-0.06517522310000001	0.23280217644772638	50000
chr10	48300000	48700000	-0.06517522310000001	0.23280217644772638	400000
chr10	49350000	49500000	-0.08829044349999998	0.13641663427905168	150000
chr10	49500000	49550000	0.41290572870000003	0.001165954139137194	50000
chr10	49550000	49850000	0.07777059350000004	0.17411581811115429	300000
chr10	49850000	49900000	0.4750678908	0.000777302759424796	50000
chr10	49900000	51150000	-0.14667321869200003	0.00388651379712398	1250000
chr10	51450000	51600000	0.18483124269999995	0.03381267003497863	150000
chr10	51750000	51850000	0.1064528642999999	0.10921103769918383	100000
chr10	52000000	52800000	0.023070768106249983	0.6292265837543723	800000
chr10	52800000	53000000	0.23959653430000005	0.012436844150796735	200000
chr10	53000000	53200000	0.51527221	0.000388651379712398	200000
chr10	53200000	54000000	0.09088241952250001	0.10376991838321026	800000
chr10	54000000	54050000	0.30594853224	0.006607073455110766	50000
chr10	54050000	54350000	-0.11407603780000002	0.07539836766420521	300000
chr10	54350000	54500000	0.30103452738	0.006995724834823164	150000
chr10	54500000	55750000	-0.0298481831064	0.08433734939759036	1250000
chr10	55750000	57700000	0.020830473456923074	0.1356393315196269	1950000
chr10	57700000	59000000	-0.03298849087384616	0.25845316750874464	1300000
chr10	59000000	59400000	0.006013190299999999	0.8997279440342013	400000
chr10	59400000	59700000	-0.11290572863333333	0.010104935872522347	300000
chr10	59700000	60600000	0.08586002271666666	0.07734162456276719	900000
chr10	60600000	60650000	-0.3261735419999999	0.00388651379712398	50000
chr10	60650000	62750000	0.14277739803095238	0.006995724834823164	2100000
chr10	62750000	63200000	-0.047355489500000014	0.34317916828604744	450000
chr10	63200000	64400000	0.10299150825833336	0.017100660707345512	1200000
chr10	64400000	64550000	-0.14253200570000002	0.06723668869024485	150000
chr10	64550000	64900000	0.046463209600000055	0.3493975903614458	350000
chr10	64900000	65200000	-0.04890728049999993	0.3233579479207151	300000
chr10	65200000	66650000	0.0328614045324138	0.3591138748542557	1450000
chr10	66650000	66800000	-0.007138238720000002	0.8849591916051301	150000
chr10	66800000	67300000	0.034967024443999996	0.07734162456276719	500000
chr10	67300000	67450000	-0.1361696625	0.07734162456276719	150000
chr10	67450000	69600000	0.036112522901627905	0.09288767975126312	2150000
chr10	69600000	71450000	-0.10907657945675679	0.006995724834823164	1850000
chr10	71450000	71850000	0.06368324067500003	0.020209871745044693	400000
chr10	71850000	71900000	-0.23829044350000006	0.012436844150796735	50000
chr10	71900000	72650000	0.08526574417999999	0.08433734939759036	750000
chr10	72650000	72700000	-0.23969998710000007	0.012436844150796735	50000
chr10	72700000	73500000	0.054938251606249995	0.00777302759424796	800000
chr10	73500000	74100000	-0.02303547573333335	0.6245627671978236	600000
chr10	74100000	74150000	0.13531617740000002	0.07734162456276719	50000
chr10	74150000	75450000	-0.08889524413846153	0.054411193159735714	1300000
chr10	75450000	75500000	0.04851933269999997	0.3253012048192771	50000
chr10	75500000	77750000	-0.06205181259333336	0.006995724834823164	2250000
chr10	77750000	78200000	0.10597439540000002	0.017100660707345512	450000
chr10	78200000	78650000	-0.12239751719999997	0.06451612903225806	450000
chr10	78650000	78850000	0.1717961980999999	0.04119704624951419	200000
chr10	78850000	78900000	-0.16604163970000008	0.04702681694520015	50000
chr10	78900000	79800000	0.04833397991666664	0.06257287213369607	900000
chr10	79800000	81100000	-0.05267932634615385	0.046638165565487756	1300000
chr10	81100000	81300000	0.08498642190000005	0.1527399922269724	200000
chr10	81300000	81500000	-0.08829690929999995	0.13641663427905168	200000
chr10	81500000	81600000	0.0026121815999999853	0.9537504858142246	100000
chr10	81600000	81850000	-0.1196172249	0.0959968907889623	250000
chr10	81850000	82000000	0.04716151560000004	0.34317916828604744	150000
chr10	82000000	82150000	-0.2551920341	0.010104935872522347	150000
chr10	82150000	82900000	0.06366395102640002	0.06723668869024485	750000
chr10	82900000	84250000	-0.04958307589777777	0.10921103769918383	1350000
chr10	84250000	84550000	0.03911806544000001	0.41896618732996505	300000
chr10	84550000	85600000	-0.02466054571371429	0.18344345122425185	1050000
chr10	85600000	86050000	0.022907596586111127	0.47532063738826275	450000
chr10	86050000	86300000	-0.009440062000000027	0.8344345122425184	250000
chr10	86300000	86850000	0.030013049151818183	0.4862028760202099	550000
chr10	86850000	87350000	-0.034999353416	0.17411581811115429	500000
chr10	87350000	87450000	0.039738781842	0.41391371939370386	100000
chr10	87450000	87800000	-0.0009310746150000002	0.9840652934317917	350000
chr10	87800000	87900000	0.216772274692	0.015157403808783521	100000
chr10	87900000	88450000	-0.052628052181818145	0.00777302759424796	550000
chr10	88450000	88700000	0.012065175300000064	0.7699183832102604	250000
chr10	88700000	88950000	-0.024363119099999997	0.617178390983288	250000
chr10	88950000	89200000	-0.257189965	0.010104935872522347	250000
chr10	89250000	91000000	-0.11460826512571427	0.002331908278274388	1750000
chr10	91000000	91550000	0.05322995903636361	0.056743101438010105	550000
chr10	91550000	91900000	0.37400750029999996	0.001554605518849592	350000
chr10	91900000	92200000	0.11184533819999998	0.10338126700349787	300000
chr10	92200000	92600000	0.2068925385	0.018655266226195105	400000
chr10	92600000	92700000	0.009595241199999993	0.8328799067236689	100000
chr10	92700000	93050000	-0.25106316155714287	0.003497862417411582	350000
chr10	93050000	93400000	0.024996767100000095	0.6078507578701905	350000
chr10	93400000	94100000	-0.125525115	0.03653322969296541	700000
chr10	94100000	94250000	-0.24086383030000003	0.012436844150796735	150000
chr10	94250000	94450000	-0.16924220865000003	0.04391760590750097	200000
chr10	94450000	95050000	-0.32198586145	0.001165954139137194	600000
chr10	95050000	95300000	0.05924996759999992	0.010882238631947143	250000
chr10	95300000	95650000	-0.34047403522857145	0.002331908278274388	350000
chr10	95650000	95750000	0.10989266770000006	0.10687912942090945	100000
chr10	95750000	96700000	-0.10069762536842103	0.011270890011659542	950000
chr10	96700000	96950000	0.03622138890000001	0.4694908666925768	250000
chr10	96950000	97100000	-0.017250743600000007	0.6976292265837544	150000
chr10	97100000	97150000	0.19356006720000002	0.024096385542168676	50000
chr10	97150000	98550000	-0.054728344203571415	0.008161678973960357	1400000
chr10	98550000	98750000	0.07224880379999998	0.18538670812281383	200000
chr10	98750000	99050000	-0.17580499159999996	0.03731053245239021	300000
chr10	99050000	99150000	0.3600801759000001	0.00194325689856199	100000
chr10	99150000	99650000	0.03073968704000004	0.26506024096385544	500000
chr10	99650000	99900000	-0.09697400749999996	0.12708900116595415	250000
chr10	99900000	100450000	0.1097022207036364	0.014380101049358725	550000
chr10	100450000	101000000	-0.00403465667	0.9362611737271668	550000
chr10	101000000	101050000	-0.4716022242299999	0.000777302759424796	50000
chr10	101050000	101350000	-0.14863571709999993	0.06451612903225806	300000
chr10	101350000	101400000	0.2413164361000001	0.012436844150796735	50000
chr10	101400000	101650000	-0.11057545575999997	0.03731053245239021	250000
chr10	101650000	101800000	0.0018233544999999296	0.9720171006607073	150000
chr10	101800000	102300000	-0.12149618515999991	0.018655266226195105	500000
chr10	102300000	102350000	0.1125177810000001	0.10338126700349787	50000
chr10	102350000	102650000	-0.13150135779999994	0.07928488146132918	300000
chr10	102650000	102850000	0.006918401700000021	0.8849591916051301	200000
chr10	102850000	103550000	-0.12607378400714286	0.014380101049358725	700000
chr10	103550000	103850000	0.07213241950000004	0.18538670812281383	300000
chr10	103850000	103950000	-0.008948661599999963	0.8406529343179169	100000
chr10	103950000	104650000	0.005405405400000007	0.9063350174893121	700000
chr10	104650000	105650000	-0.090732574675	0.018655266226195105	1000000
chr10	105650000	106100000	0.12516631465555556	0.054411193159735714	450000
chr10	106100000	106150000	0.6560972456	0.000388651379712398	50000
chr10	106150000	106400000	-0.016151558300000035	0.7065682083171395	250000
chr10	106400000	106750000	0.06264063106000001	0.24212980956082394	350000
chr10	106750000	107500000	-0.04946247683399999	0.17411581811115429	750000
chr10	107500000	108000000	0.07622785467000001	0.07151185386708123	500000
chr10	108000000	108400000	-0.31207810677500003	0.001554605518849592	400000
chr10	108400000	109100000	0.07751473275	0.1554605518849592	700000
chr10	109100000	109150000	-0.2800336222	0.007384376214535562	50000
chr10	109150000	109550000	0.1541769041625	0.04741546832491255	400000
chr10	109550000	110350000	0.34563882068749996	0.000777302759424796	800000
chr10	110350000	110700000	0.022362417128571423	0.6004663816556549	350000
chr10	110700000	111250000	-0.09489202118545456	0.06723668869024485	550000
chr10	111250000	112800000	0.06077973326580645	0.06451612903225806	1550000
chr10	112800000	112900000	-0.3810034915	0.001554605518849592	100000
chr10	112900000	113900000	0.07890210785699998	0.00388651379712398	1000000
chr10	113900000	114450000	-0.1721206634727273	0.010882238631947143	550000
chr10	114450000	114900000	0.06828024199999999	0.10687912942090945	450000
chr10	114900000	115400000	-0.05948532270000002	0.25612125923047024	500000
chr10	115400000	115600000	0.08884003619999997	0.13641663427905168	200000
chr10	115600000	116000000	-0.12847051591249997	0.06723668869024485	400000
chr10	116000000	116300000	0.021569895199999967	0.6529343179168287	300000
chr10	116300000	118150000	-0.07664729257837835	0.000777302759424796	1850000
chr10	118150000	118400000	0.030117677510000006	0.5417800233190828	250000
chr10	118400000	118800000	0.23004170441375	0.000777302759424796	400000
chr10	118800000	119000000	-0.03702314750000002	0.45394481150408084	200000
chr10	119000000	119150000	0.05878701669999997	0.25806451612903225	150000
chr10	119150000	119250000	-0.2306866675	0.014380101049358725	100000
chr10	119250000	119550000	0.09451700503333332	0.078118927322192	300000
chr10	119550000	120200000	-0.07117349224615387	0.046638165565487756	650000
chr10	120200000	120450000	0.07767748608	0.06723668869024485	250000
chr10	120450000	120750000	-0.08281391435000005	0.07151185386708123	300000
chr10	120750000	120800000	0.22819087029999996	0.014380101049358725	50000
chr10	120800000	121300000	-0.08375533432999999	0.03731053245239021	500000
chr10	121300000	121700000	0.029290055600000087	0.567431014380101	400000
chr10	121700000	122100000	-0.07113668690000002	0.18577535950252624	400000
chr10	122100000	122150000	0.37144704520000005	0.001554605518849592	50000
chr10	122150000	123100000	-0.04689063272105263	0.001554605518849592	950000
chr10	123100000	123450000	0.05852469011428574	0.09988340458608629	350000
chr10	123450000	123500000	-0.1935988621	0.024096385542168676	50000
chr10	123500000	123650000	0.282477693	0.007384376214535562	150000
chr10	123650000	123850000	0.0013966119999999638	0.9774582199766809	200000
chr10	123850000	124050000	0.244209879725	0.006995724834823164	200000
chr10	124050000	124350000	0.12815207550000007	0.08083948698017877	300000
chr10	124350000	124600000	-0.020949178800000023	0.6638165565487757	250000
chr10	124600000	124900000	0.12110004745000003	0.05363389040031092	300000
chr10	124900000	124950000	-0.015065304499999987	0.7186164010882239	50000
chr10	124950000	125900000	0.10572188911578946	0.05207928488146133	950000
chr10	125900000	126050000	-0.02430277163333335	0.2308589195491644	150000
chr10	126050000	126300000	0.0179878443	0.6871356393315197	250000
chr10	126300000	126600000	-0.053618690416666615	0.0777302759424796	300000
chr10	126600000	127150000	0.09750420277272726	0.014380101049358725	550000
chr10	127150000	127400000	-0.06125695069999998	0.2518460940536339	250000
chr10	127400000	128200000	0.17305541181875	0.026428293820443063	800000
chr10	128200000	128350000	-0.3142635459	0.005441119315973571	150000
chr10	128350000	128650000	0.07421871628333333	0.17411581811115429	300000
chr10	128750000	129050000	0.07135975689999995	0.06723668869024485	300000
chr10	129050000	129250000	-0.016785206200000014	0.6999611348620287	200000
chr10	129250000	129650000	0.028152075487499983	0.06723668869024485	400000
chr10	129650000	129700000	-0.35616190350000004	0.003109211037699184	50000
chr10	129700000	129900000	0.22517780939999998	0.014380101049358725	200000
chr10	129900000	129950000	-0.4327169274	0.001165954139137194	50000
chr10	129950000	130350000	0.0564722617	0.2670034978624174	400000
chr10	130350000	130800000	-0.05631708262999999	0.2670034978624174	450000
chr10	130800000	130900000	0.11832406571000001	0.0959968907889623	100000
chr10	130900000	131800000	-0.05330761382444443	0.18538670812281383	900000
chr10	131800000	132300000	0.06018362862000002	0.010493587252234746	500000
chr10	132300000	133700000	-0.0945788919357143	0.08433734939759036	1400000
chr10	133700000	133850000	0.15993792839999998	0.054411193159735714	150000
chr10	133850000	134050000	-0.03144963140000001	0.5305091333074232	200000
chr10	134050000	134100000	0.16472261739999994	0.04741546832491255	50000
chr10	134100000	134300000	-0.021763869100000055	0.6490478041197046	200000
chr10	134300000	135250000	0.05385599653684206	0.10921103769918383	950000
chr10	135250000	135450000	-0.03419112889999998	0.4795958025650991	200000
chr10	135450000	135534747	0.1141342299	0.10221531286436067	84747
chr11	200000	850000	0.0680971907461539	0.19383429672447014	650000
chr11	900000	1150000	-0.08501838239999993	0.1533718689788054	250000
chr11	1200000	1450000	0.00742953430000004	0.8786127167630058	250000
chr11	1500000	1700000	0.04369638479999999	0.18458574181117535	200000
chr11	1700000	1900000	-0.18826593140000003	0.02581888246628131	200000
chr11	1900000	2000000	0.03048406859999997	0.566859344894027	100000
chr11	2000000	2300000	-0.06735089870000004	0.15953757225433526	300000
chr11	2300000	2700000	0.056066176450000005	0.028516377649325627	400000
chr11	2700000	2750000	-0.09666053919999995	0.12177263969171484	50000
chr11	2750000	2900000	0.006280637299999947	0.9013487475915222	150000
chr11	2900000	3200000	-0.0438112745	0.40809248554913297	300000
chr11	3200000	3300000	0.013710171599999987	0.7734104046242775	100000
chr11	3350000	3500000	0.013710171599999987	0.7734104046242775	150000
chr11	3550000	3650000	0.013710171599999987	0.7734104046242775	100000
chr11	3650000	3700000	-0.22717524509999998	0.01233140655105973	50000
chr11	3700000	4250000	0.09381266709999997	0.11136801541425818	550000
chr11	4350000	5550000	0.10241459866666669	0.017726396917148363	1200000
chr11	5550000	5750000	-0.007046568600000025	0.8928709055876686	200000
chr11	5750000	5850000	-0.2276348039	0.01233140655105973	100000
chr11	5850000	8200000	0.07791314663404257	0.02581888246628131	2350000
chr11	8200000	8400000	-0.05958946077499998	0.023892100192678227	200000
chr11	8400000	8600000	0.05851715679999997	0.31868978805394993	200000
chr11	8600000	9150000	-0.046498997272727244	0.3599229287090559	550000
chr11	9150000	9200000	0.033854166699999966	0.5159922928709055	50000
chr11	9200000	9400000	-0.057291666699999966	0.3267822736030829	200000
chr11	9400000	9950000	0.03616588683636366	0.044701348747591525	550000
chr11	9950000	10800000	-0.11722354381176472	0.03815028901734104	850000
chr11	10800000	11800000	0.06001072300999999	0.11136801541425818	1000000
chr11	11800000	11850000	-0.2356004902	0.011175337186897881	50000
chr11	11850000	11950000	0.32077205889999993	0.002697495183044316	100000
chr11	11950000	12950000	-0.02481617646499999	0.522543352601156	1000000
chr11	12950000	13450000	0.05767463240000004	0.21772639691714837	500000
chr11	13450000	13500000	0.47564338240000004	0.0007707129094412332	50000
chr11	13500000	13650000	-0.007199754900000022	0.8901734104046243	150000
chr11	13650000	14550000	0.06090005448888888	0.08362235067437379	900000
chr11	14550000	14850000	-0.011182597999999988	0.8208092485549133	300000
chr11	14850000	15100000	0.023131127500000015	0.6535645472061657	250000
chr11	15100000	15600000	0.217310049	0.0038535645472061657	500000
chr11	15600000	16050000	0.6787343409555555	0.0003853564547206166	450000
chr11	16050000	16750000	0.3152354691492857	0.0019267822736030828	700000
chr11	16750000	17000000	-0.13710171569999996	0.06358381502890173	250000
chr11	17000000	17400000	0.046894148325000024	0.37071290944123314	400000
chr11	17400000	17750000	-0.04372373955714282	0.13217726396917148	350000
chr11	17750000	18050000	0.11861723863333333	0.044701348747591525	300000
chr11	18050000	18300000	-0.02435661760000002	0.6420038535645473	250000
chr11	18300000	18800000	0.13996629901999996	0.044701348747591525	500000
chr11	18800000	19100000	-0.04008374179999996	0.02581888246628131	300000
chr11	19100000	19300000	0.16789215690000003	0.04007707129094412	200000
chr11	19300000	19950000	-0.03955740946923077	0.3333333333333333	650000
chr11	19950000	20500000	0.05156807040909092	0.3333333333333333	550000
chr11	20500000	20650000	-0.04171772873333334	0.14104046242774568	150000
chr11	20650000	21250000	0.02221200980083334	0.03236994219653179	600000
chr11	21250000	21350000	-0.019148284309999992	0.7036608863198458	100000
chr11	21350000	22850000	0.04463337416766666	0.12947976878612716	1500000
chr11	22850000	25300000	-0.19270520709591835	0.0011560693641618498	2450000
chr11	25300000	25950000	0.03385416667000001	0.5159922928709055	650000
chr11	25950000	26200000	-0.022671568599999997	0.6566473988439306	250000
chr11	26200000	26650000	0.06634667756666668	0.02581888246628131	450000
chr11	26650000	26750000	-0.20235906859999997	0.017726396917148363	100000
chr11	26750000	28200000	0.09185365955517245	0.016570327552986513	1450000
chr11	28200000	29350000	-0.15406543050869564	0.004238921001926782	1150000
chr11	29350000	29400000	0.2395833334	0.011175337186897881	50000
chr11	29400000	30250000	-0.02115772779117647	0.007321772639691715	850000
chr11	30250000	32150000	0.13405814628694737	0.0038535645472061657	1900000
chr11	32150000	32200000	-0.1533394608	0.048554913294797684	50000
chr11	32200000	33350000	0.09133232094782608	0.07591522157996146	1150000
chr11	33350000	33800000	-0.004323257155555544	0.6867052023121387	450000
chr11	33800000	34050000	-0.2876838235	0.004238921001926782	250000
chr11	34050000	34400000	0.04599964984285714	0.22119460500963392	350000
chr11	34400000	34700000	-0.07904411769999997	0.1880539499036609	300000
chr11	34700000	34900000	-0.3046875	0.0030828516377649326	200000
chr11	34900000	35000000	0.06786151959999998	0.22427745664739884	100000
chr11	35000000	35400000	-0.02068014709999999	0.6847784200385356	400000
chr11	35400000	36550000	0.08278053067826088	0.007321772639691715	1150000
chr11	36550000	37600000	-0.032110760962857136	0.03275529865125241	1050000
chr11	37600000	38850000	-0.3363112744912	0.0007707129094412332	1250000
chr11	38850000	39300000	-0.06464460784	0.25626204238921	450000
chr11	39300000	40500000	0.0642105800625	0.02581888246628131	1200000
chr11	40500000	41150000	-0.04387019230692308	0.3915221579961464	650000
chr11	41150000	42350000	0.02710120508083333	0.23545279383429674	1200000
chr11	42350000	42900000	-0.06492312834636364	0.026589595375722544	550000
chr11	42900000	42950000	0.016544117650000002	0.7406551059730251	50000
chr11	42950000	43300000	-0.053768382320000016	0.3468208092485549	350000
chr11	43300000	44250000	0.042988906063157854	0.05433526011560694	950000
chr11	44250000	44550000	-0.0715124590833333	0.025048169556840076	300000
chr11	44550000	45100000	0.02874331548181821	0.10520231213872833	550000
chr11	45100000	45400000	-0.024356617599999963	0.6420038535645473	300000
chr11	45400000	45850000	0.04290917757777776	0.39922928709055877	450000
chr11	45850000	46450000	-0.04483251630000007	0.2535645472061657	600000
chr11	46450000	46950000	0.023177083320000014	0.5826589595375723	500000
chr11	46950000	47650000	-0.010066526628571437	0.8138728323699422	700000
chr11	47650000	47850000	0.08026960780000003	0.18188824662813102	200000
chr11	47850000	48150000	-0.1211703430833334	0.05433526011560694	300000
chr11	48150000	48200000	0.6432291667	0.0007707129094412332	50000
chr11	48200000	48700000	-0.13373161765000002	0.06897880539499036	500000
chr11	48700000	48850000	0.04217728753333333	0.315606936416185	150000
chr11	48950000	49000000	0.0091911764	0.8389210019267823	50000
chr11	49000000	49800000	-0.044117647059999994	0.40809248554913297	800000
chr11	49800000	50000000	0.07720588240000001	0.19113680154142582	200000
chr11	50000000	50750000	-0.08670343135000001	0.06165703275529865	750000
chr11	51200000	51550000	0.0447303922	0.405009633911368	350000
chr11	51550000	51600000	-0.032245710799999994	0.5360308285163776	50000
chr11	54800000	54900000	-0.032245710799999994	0.5360308285163776	100000
chr11	54900000	55050000	0.12270220586999998	0.08169556840077072	150000
chr11	55050000	55400000	-0.008425245090000005	0.8524084778420039	350000
chr11	55400000	56200000	0.02420343136875	0.6150289017341041	800000
chr11	56200000	56600000	-0.02824371935875	0.12909441233140656	400000
chr11	56600000	57850000	0.09775122545999998	0.023506743737957612	1250000
chr11	57850000	58300000	-0.07587826797777779	0.0038535645472061657	450000
chr11	58300000	58700000	0.09503293501250001	0.06435452793834297	400000
chr11	58700000	59300000	-0.019914215649999983	0.5691714836223507	600000
chr11	59300000	61050000	0.0824842437057143	0.0011560693641618498	1750000
chr11	61050000	61600000	-0.05621936270000005	0.3310211946050096	550000
chr11	61600000	61750000	0.16513480390000002	0.04238921001926782	150000
chr11	61750000	62150000	-0.28952205884999993	0.0011560693641618498	400000
chr11	62150000	62650000	-0.020220588199999945	0.6890173410404624	500000
chr11	62650000	62700000	0.44852941180000006	0.0007707129094412332	50000
chr11	62700000	63500000	-0.03766467521249999	0.16377649325626203	800000
chr11	63500000	63550000	0.12423406859999997	0.08092485549132948	50000
chr11	63550000	64100000	-0.08331940731818183	0.06435452793834297	550000
chr11	64100000	64150000	0.09497549020000007	0.1252408477842004	50000
chr11	64150000	64500000	-0.19424019609999998	0.023506743737957612	350000
chr11	64500000	65100000	0.11596200980000004	0.048554913294797684	600000
chr11	65250000	65300000	0.07268688729999995	0.20154142581888246	50000
chr11	65400000	67300000	0.13300801404999993	0.0007707129094412332	1900000
chr11	67300000	67600000	-0.011948529400000019	0.8138728323699422	300000
chr11	67700000	69100000	-0.15702687327857143	0.004238921001926782	1400000
chr11	69150000	69700000	-0.13890513593636358	0.048554913294797684	550000
chr11	69800000	70250000	-0.09292449623333326	0.057803468208092484	450000
chr11	70250000	70300000	0.2218137255	0.01233140655105973	50000
chr11	70300000	71350000	-0.13075907447619048	0.016570327552986513	1050000
chr11	71400000	71450000	-0.11328124999999994	0.09826589595375723	50000
chr11	71450000	71500000	-0.4322916666	0.0007707129094412332	50000
chr11	71500000	72550000	0.03660422507142858	0.4458574181117534	1050000
chr11	72550000	72850000	-0.13985906869999998	0.05857418111753372	300000
chr11	72850000	74700000	0.08056355988378373	0.0011560693641618498	1850000
chr11	74700000	76750000	-0.11402289573170733	0.011175337186897881	2050000
chr11	76750000	76900000	0.03814338230000003	0.4705202312138728	150000
chr11	76900000	76950000	-0.01654411769999997	0.7406551059730251	50000
chr11	76950000	77350000	0.02757352940000002	0.5946050096339114	400000
chr11	77350000	78200000	-0.10567149654117644	0.026204238921001925	850000
chr11	78200000	78350000	0.010263480400000025	0.8323699421965318	150000
chr11	78350000	79200000	-0.16692798442941176	0.0038535645472061657	850000
chr11	79200000	79250000	0.2458639706	0.009248554913294798	50000
chr11	79250000	79600000	-0.050704656899999985	0.3622350674373796	350000
chr11	79600000	80950000	0.03082448256666667	0.17148362235067438	1350000
chr11	80950000	82350000	-0.028793548674	0.11329479768786127	1400000
chr11	82350000	82400000	0.1311274509	0.07013487475915221	50000
chr11	82400000	82600000	-0.06158088240000001	0.28015414258188825	200000
chr11	82600000	83550000	0.08669536891052634	0.0007707129094412332	950000
chr11	83550000	84850000	-0.022848322021076926	0.05433526011560694	1300000
chr11	84850000	85650000	0.08625344672312502	0.1252408477842004	800000
chr11	85650000	85950000	-0.05392156860000008	0.3468208092485549	300000
chr11	85950000	86000000	0.11014093139999992	0.10520231213872833	50000
chr11	86000000	87700000	-0.1033534277470588	0.004238921001926782	1700000
chr11	87750000	89350000	0.13411697686562501	0.004238921001926782	1600000
chr11	89350000	89400000	-0.11381740200000001	0.0951830443159923	50000
chr11	89400000	89500000	0.13227634800000002	0.07013487475915221	100000
chr11	89800000	90000000	0.13227634800000002	0.07013487475915221	200000
chr11	90000000	90850000	-0.01868872549117647	0.6959537572254335	850000
chr11	90850000	91800000	0.03538602941052632	0.1907514450867052	950000
chr11	91800000	91950000	-0.13664215686	0.06435452793834297	150000
chr11	91950000	93550000	0.08797679227968752	0.044701348747591525	1600000
chr11	93550000	93600000	-0.2541360294	0.008092485549132947	50000
chr11	93600000	94100000	0.05366115196	0.01233140655105973	500000
chr11	94100000	94450000	-0.012057948214285756	0.3464354527938343	350000
chr11	94450000	94900000	0.21132897602222223	0.0007707129094412332	450000
chr11	94900000	95500000	-0.038054023658333325	0.011175337186897881	600000
chr11	95500000	95800000	0.029411764700000065	0.5764932562620424	300000
chr11	95800000	96100000	-0.02129289219999997	0.6801541425818882	300000
chr11	96100000	96150000	0.7612591912	0.0003853564547206166	50000
chr11	96150000	96300000	-0.08800551470000001	0.13911368015414258	150000
chr11	96400000	96700000	-0.08800551470000001	0.13911368015414258	300000
chr11	96700000	96850000	0.043504901929999985	0.40809248554913297	150000
chr11	96850000	98200000	-0.10228871640185185	0.02581888246628131	1350000
chr11	98200000	98850000	0.021210407240000003	0.17148362235067438	650000
chr11	98850000	100550000	-0.1353355680782353	0.002697495183044316	1700000
chr11	100550000	100850000	0.2925857843	0.004238921001926782	300000
chr11	100850000	101700000	0.03526888699588236	0.2535645472061657	850000
chr11	101700000	101950000	0.11917892160000006	0.08631984585741811	250000
chr11	101950000	102500000	-0.01623774509999998	0.7433526011560694	550000
chr11	102500000	102550000	-0.33241421569999996	0.0019267822736030828	50000
chr11	102550000	103000000	-0.0661254085333333	0.07938342967244702	450000
chr11	103000000	104600000	-0.336578967534375	0.0007707129094412332	1600000
chr11	104600000	105200000	-0.18827869691666668	0.01233140655105973	600000
chr11	105200000	105800000	-0.28661151960000003	0.004238921001926782	600000
chr11	105800000	105950000	-0.07827818620000004	0.18998073217726397	150000
chr11	105950000	106600000	0.12279647436923075	0.005780346820809248	650000
chr11	106600000	106650000	-0.12852328429999998	0.07591522157996146	50000
chr11	106650000	107150000	0.11449142156	0.011560693641618497	500000
chr11	107150000	107200000	-0.09727328430000004	0.11830443159922929	50000
chr11	107200000	107300000	0.0718443627	0.205009633911368	100000
chr11	107300000	107750000	-0.1874659586444444	0.0019267822736030828	450000
chr11	107750000	107900000	0.13863357850000002	0.06165703275529865	150000
chr11	107900000	108500000	-0.07508680555000004	0.048554913294797684	600000
chr11	108500000	108700000	0.026501225500000003	0.6127167630057804	200000
chr11	108700000	109300000	-0.07594209557500002	0.10404624277456648	600000
chr11	109300000	109800000	-0.24497549019999995	0.0019267822736030828	500000
chr11	109800000	110200000	-0.13097426469999995	0.07013487475915221	400000
chr11	110200000	110350000	-0.41038602939999996	0.0007707129094412332	150000
chr11	110350000	111100000	0.3606924019833332	0.0007707129094412332	750000
chr11	111100000	111950000	0.12684724624705881	0.026589595375722544	850000
chr11	111950000	112150000	0.3193933823999999	0.002697495183044316	200000
chr11	112150000	113000000	0.10629325258235293	0.018497109826589597	850000
chr11	113000000	113150000	0.2579656862	0.007321772639691715	150000
chr11	113150000	113400000	-0.007659313799999956	0.8786127167630058	250000
chr11	113400000	114350000	0.10790763674210527	0.002697495183044316	950000
chr11	114350000	114950000	-0.07425704657333332	0.11136801541425818	600000
chr11	114950000	115050000	0.07843137250000001	0.18998073217726397	100000
chr11	115050000	115400000	-0.06797093837142856	0.21926782273603082	350000
chr11	115400000	115600000	0.03952205889999999	0.44778420038535643	200000
chr11	115600000	115800000	-0.007965686200000016	0.8697495183044316	200000
chr11	115800000	117800000	0.06563265932999998	0.024277456647398842	2000000
chr11	117800000	118250000	-0.0124080882	0.8034682080924855	450000
chr11	118250000	118450000	0.13848039212500007	0.016570327552986513	200000
chr11	118450000	118800000	-0.09097076331428573	0.018111753371868978	350000
chr11	118800000	119700000	0.0809163943166667	0.01233140655105973	900000
chr11	119700000	120200000	-0.027879902000000012	0.5892100192678227	500000
chr11	120200000	120350000	0.13250612750000001	0.07013487475915221	150000
chr11	120350000	120850000	-0.007659313700000003	0.8786127167630058	500000
chr11	120850000	121500000	0.04121889136923075	0.009248554913294798	650000
chr11	121500000	121950000	-0.08088235300000002	0.17148362235067438	450000
chr11	121950000	122100000	0.14767156869999998	0.05433526011560694	150000
chr11	122100000	122450000	-0.1271446078	0.07938342967244702	350000
chr11	122450000	122500000	0.5076593138000001	0.0007707129094412332	50000
chr11	122500000	122900000	-0.03707107840000001	0.42042389210019265	400000
chr11	122900000	123100000	0.09930300250000001	0.044701348747591525	200000
chr11	123100000	123150000	-0.2996323529	0.0038535645472061657	50000
chr11	123150000	123300000	-0.01838235290000001	0.7117533718689788	150000
chr11	123300000	124250000	0.08640512128947365	0.0951830443159923	950000
chr11	124250000	124450000	-0.023590686299999997	0.6535645472061657	200000
chr11	124450000	125550000	0.18899008466818187	0.002697495183044316	1100000
chr11	125550000	125950000	-0.08034620094999997	0.05433526011560694	400000
chr11	125950000	126250000	0.08522263066666669	0.004238921001926782	300000
chr11	126250000	126300000	-0.12147671570000007	0.08362235067437379	50000
chr11	126300000	126500000	0.07383578429999993	0.19961464354527939	200000
chr11	126500000	126550000	-0.04381127450000005	0.40809248554913297	50000
chr11	126550000	126900000	0.1567095588	0.04816955684007707	350000
chr11	126900000	127350000	-0.020441857322222225	0.09171483622350675	450000
chr11	127350000	130300000	0.12945019108644065	0.0011560693641618498	2950000
chr11	130300000	130800000	-0.16957720585000008	0.014258188824662813	500000
chr11	130800000	131100000	0.08042279420000004	0.18188824662813102	300000
chr11	131100000	131450000	-0.02987132349999999	0.5691714836223507	350000
chr11	131450000	131550000	0.29856004910000006	0.0038535645472061657	100000
chr11	131550000	131800000	-0.08164828429999993	0.17148362235067438	250000
chr11	131800000	132200000	0.22709865190000006	0.004238921001926782	400000
chr11	132200000	132250000	-0.06464460779999998	0.25626204238921	50000
chr11	132250000	132400000	0.060355392200000024	0.29441233140655104	150000
chr11	132400000	132850000	-0.052032271199999945	0.2674373795761079	450000
chr11	132850000	132950000	0.1875	0.02581888246628131	100000
chr11	132950000	133200000	-0.008578431400000003	0.8524084778420039	250000
chr11	133200000	133800000	0.04743668298333334	0.08901734104046242	600000
chr11	133800000	134000000	-0.17938112750000001	0.026204238921001925	200000
chr11	134000000	134450000	0.09696691176666665	0.0489402697495183	450000
chr11	134450000	134500000	-0.03324142150000001	0.522543352601156	50000
chr11	134500000	134950000	0.10142633444444443	0.045857418111753374	450000
chr12	200000	400000	-0.16982664880000004	0.04608830364058869	200000
chr12	400000	450000	0.20548199319999993	0.027498063516653758	50000
chr12	450000	1100000	-0.03325115999999999	0.0592563903950426	650000
chr12	1100000	6050000	0.11393025760555557	0.0077459333849728895	4950000
chr12	6050000	6150000	-0.24956822110000004	0.011231603408210689	100000
chr12	6150000	6400000	0.2516663468	0.011231603408210689	250000
chr12	6400000	6600000	-0.056623808599999936	0.25290472501936484	200000
chr12	6600000	7100000	0.03630301293000001	0.0038729666924864447	500000
chr12	7100000	7200000	-0.03376511230000001	0.4442292796281952	100000
chr12	7250000	7350000	-0.03376511230000001	0.4442292796281952	100000
chr12	7350000	8350000	0.13486854730500003	0.04608830364058869	1000000
chr12	8600000	9150000	0.06086803549999997	0.21843532145623548	550000
chr12	9150000	9450000	-0.049013305183333335	0.04298993028659954	300000
chr12	9450000	9550000	0.12500159919999998	0.07242447714949651	100000
chr12	9750000	9850000	0.12500159919999998	0.07242447714949651	100000
chr12	9850000	9900000	-0.0885786478	0.12470952749806352	50000
chr12	9900000	12200000	0.1092892960521739	0.026336173508907823	2300000
chr12	12200000	12850000	-0.1410025143846153	0.011231603408210689	650000
chr12	12850000	16450000	0.11612907524819446	0.0038729666924864447	3600000
chr12	16450000	19300000	-0.07837671321456141	0.019364833462432222	2850000
chr12	19300000	19700000	0.07448986115000006	0.08481797056545314	400000
chr12	19700000	19850000	-0.03179811939999999	0.465143299767622	150000
chr12	19850000	20150000	0.07437472010000001	0.1785437645236251	300000
chr12	20150000	20500000	-0.04138681000000005	0.36986831913245544	350000
chr12	20500000	25000000	0.15609323581111112	0.0011618900077459333	4500000
chr12	25000000	25550000	-0.0746032576363636	0.07164988381099922	550000
chr12	25550000	26100000	0.0962113942727272	0.11192873741285825	550000
chr12	26100000	26500000	-0.023560736875000016	0.5999225406661503	400000
chr12	26500000	26550000	0.073958933	0.1785437645236251	50000
chr12	26550000	27350000	-0.09563183650625004	0.07591014717273431	800000
chr12	27350000	27850000	0.07014328665000001	0.07242447714949651	500000
chr12	27850000	28100000	-0.045128894000000086	0.3342370255615802	250000
chr12	28100000	28400000	-0.2179684002000001	0.020139426800929512	300000
chr12	28400000	28750000	-0.08385466649999995	0.14523625096824166	350000
chr12	28750000	29250000	-0.34382716050999995	0.0023237800154918666	500000
chr12	29250000	29550000	-0.09117891639999998	0.12161115414407436	300000
chr12	29550000	29950000	-0.3455766648	0.003098373353989156	400000
chr12	29950000	30000000	-0.17718288239999996	0.04298993028659954	50000
chr12	30000000	30500000	-0.22280112582	0.018977536793183578	500000
chr12	30500000	30950000	-0.06201198318888888	0.11463981409759876	450000
chr12	30950000	31000000	-0.28652849739999997	0.008133230054221533	50000
chr12	31000000	31200000	0.03471502590000003	0.4326103795507359	200000
chr12	31250000	32850000	-0.07595890904062497	0.032532920216886134	1600000
chr12	32850000	32900000	0.2381116868	0.013942680092951201	50000
chr12	32900000	34200000	-0.08306294867692307	0.04066615027110767	1300000
chr12	34200000	34450000	0.05685920806	0.17660728117738186	250000
chr12	34450000	34600000	-0.0004925477999999928	0.9748257164988381	150000
chr12	34600000	34800000	0.021812831799999988	0.6161890007745934	200000
chr12	37850000	38000000	0.013295592660000001	0.7490317583268784	150000
chr12	38150000	38450000	0.01329559266	0.7490317583268784	300000
chr12	38450000	38500000	-0.03981321563	0.38574748257164987	50000
chr12	38500000	39050000	0.022016945489090913	0.3458559256390395	550000
chr12	39050000	39700000	-0.02050051910923077	0.1665375677769171	650000
chr12	39700000	39850000	0.1370882109	0.06390395042602634	150000
chr12	39850000	39900000	-0.03822043110000001	0.4004647560030984	50000
chr12	39900000	40050000	0.15608008699999998	0.05034856700232378	150000
chr12	40050000	40500000	-0.009352011769999995	0.7939581719597212	450000
chr12	40500000	40800000	0.0807074778	0.15182029434546862	300000
chr12	40800000	41100000	-0.061056738948333335	0.1924864446165763	300000
chr12	41100000	41450000	0.007445787760000003	0.8284275755228505	350000
chr12	41450000	42100000	-0.0378297388656923	0.18009295120061966	650000
chr12	42100000	44250000	0.08229788208453488	0.010069713400464756	2150000
chr12	44250000	44300000	-0.1920424743	0.03679318357862122	50000
chr12	44300000	44750000	0.017802085299999992	0.6820294345468629	450000
chr12	44750000	45550000	-0.036311008765	0.044151820294345466	800000
chr12	45550000	46500000	0.0860409996052632	0.044151820294345466	950000
chr12	46500000	46550000	-0.03314143159999994	0.45546088303640586	50000
chr12	46550000	46750000	0.04587091409999999	0.3326878388845856	200000
chr12	46750000	47000000	-0.03015416110000002	0.4895429899302866	250000
chr12	47000000	47300000	0.05611207060000001	0.25639039504260264	300000
chr12	47300000	47450000	-0.1252350795999999	0.07242447714949651	150000
chr12	47450000	48100000	-0.3642856087846153	0.0023237800154918666	650000
chr12	48100000	48300000	-0.1531631805	0.05073586367157242	200000
chr12	48300000	48600000	0.05927205270000002	0.238574748257165	300000
chr12	48600000	49000000	-0.029437727899999988	0.5	400000
chr12	49000000	49050000	0.7310560993	0.0003872966692486445	50000
chr12	49050000	49300000	0.07820635840000001	0.15724244771494966	250000
chr12	49300000	49900000	0.009686240700000015	0.6161890007745934	600000
chr12	49900000	50150000	0.0829847118	0.14717273431448488	250000
chr12	50150000	50600000	0.0022779447777778244	0.9504260263361735	450000
chr12	50600000	50750000	0.10285933609999998	0.09798605731990705	150000
chr12	50750000	51200000	0.03291114949999996	0.45546088303640586	450000
chr12	51200000	51400000	-0.06928452634999996	0.011618900077459334	200000
chr12	51400000	51550000	0.004701592800000043	0.8698683191324554	150000
chr12	51550000	51850000	-0.016023795800000018	0.7130131680867544	300000
chr12	51850000	52200000	0.045583975285714305	0.32261812548412083	350000
chr12	52200000	52400000	-0.06628925990000001	0.19016266460108444	200000
chr12	52400000	52700000	0.018991876100000082	0.6638264910921766	300000
chr12	52700000	52750000	-0.31434145719999995	0.0038729666924864447	50000
chr12	52750000	53000000	0.05353419050000002	0.26800929512006194	250000
chr12	53000000	53300000	-0.06639373969999995	0.10534469403563129	300000
chr12	53300000	53400000	0.40932642490000004	0.0011618900077459333	100000
chr12	53400000	54150000	0.038860103599999994	0.15375677769171184	750000
chr12	54150000	54200000	0.5595854922	0.0003872966692486445	50000
chr12	54200000	54350000	-0.05029105100000003	0.29938032532920217	150000
chr12	54350000	54400000	0.058350924299999996	0.2428350116189001	50000
chr12	54400000	54600000	-0.011597262200000014	0.7618125484120837	200000
chr12	54600000	55050000	0.03544922783333335	0.25290472501936484	450000
chr12	55050000	55500000	-0.0706006525	0.1812548412083656	450000
chr12	55500000	56000000	0.05071323480000001	0.29434546862896976	500000
chr12	56000000	56050000	0.7618243459	0.0003872966692486445	50000
chr12	56050000	57400000	-0.08035684247037037	0.02517428350116189	1350000
chr12	57400000	57450000	0.12634171309999997	0.07164988381099922	50000
chr12	57450000	57650000	-0.06795880500000007	0.1890007745933385	200000
chr12	57650000	57950000	0.003927589100000017	0.9000774593338497	300000
chr12	57950000	58350000	-0.06039147960000002	0.22192099147947328	400000
chr12	58350000	59550000	0.13128744750000002	0.027498063516653758	1200000
chr12	59550000	60950000	-0.049187844382142874	0.1855151045701007	1400000
chr12	60950000	61600000	0.006047857336923077	0.6855151045701007	650000
chr12	61600000	61800000	-0.016234887729999994	0.7130131680867544	200000
chr12	61800000	62600000	0.0228722893875	0.1812548412083656	800000
chr12	62600000	62650000	-0.45903537389000004	0.000774593338497289	50000
chr12	62650000	63000000	0.20022388540000002	0.032532920216886134	350000
chr12	63000000	63500000	-0.011694492440000004	0.7238574748257165	500000
chr12	63500000	64000000	0.11503230340000001	0.08481797056545314	500000
chr12	64000000	64200000	-0.1803044841	0.04298993028659954	200000
chr12	64200000	65150000	0.043362724663157916	0.0023237800154918666	950000
chr12	65150000	65550000	-0.006166442800000005	0.8396591789310612	400000
chr12	65550000	65650000	0.3790187424	0.0023237800154918666	100000
chr12	65650000	65900000	-0.07434913330000004	0.1785437645236251	250000
chr12	65900000	66500000	0.038361159099999965	0.3601859024012393	600000
chr12	66500000	66550000	0.593628862	0.0003872966692486445	50000
chr12	66550000	66850000	-0.042173607133333325	0.048799380325329204	300000
chr12	66850000	68200000	0.17605705876481478	0.010069713400464756	1350000
chr12	68200000	68350000	-0.008475660400000029	0.8113865220759101	150000
chr12	68350000	69250000	0.11114806994444441	0.03446940356312936	900000
chr12	69250000	69750000	-0.1513113286	0.037180480247869865	500000
chr12	69750000	70400000	0.08900944256153845	0.017815646785437646	650000
chr12	70400000	70600000	-0.08052197279999998	0.15182029434546862	200000
chr12	70600000	70900000	0.04751913689999999	0.03989155693261038	300000
chr12	70900000	71800000	-0.11100947426555553	0.011231603408210689	900000
chr12	71800000	71950000	0.018364997100000002	0.6777691711851278	150000
chr12	71950000	72150000	-0.003908398900000054	0.9000774593338497	200000
chr12	72150000	74650000	0.05545423144119999	0.03446940356312936	2500000
chr12	74650000	74900000	-0.16623424806199996	0.0034856700232378003	250000
chr12	74900000	75050000	0.015000319799999995	0.7296669248644462	150000
chr12	75050000	75700000	-0.06859257291538466	0.06545313710302092	650000
chr12	75700000	76450000	0.020028572046666717	0.2691711851278079	750000
chr12	76450000	76750000	-0.016957717699999986	0.691711851278079	300000
chr12	76750000	76950000	0.05845966859999996	0.2412858249419055	200000
chr12	76950000	78300000	-0.15178006637407404	0.0038729666924864447	1350000
chr12	78300000	78600000	0.02673830999999995	0.25290472501936484	300000
chr12	78600000	79050000	-0.06858141963333336	0.1812548412083656	450000
chr12	79050000	79450000	0.03310305124999996	0.3094500387296669	400000
chr12	79450000	79800000	-0.03463826520000002	0.43532145623547636	350000
chr12	79800000	80150000	0.03522036719999999	0.4326103795507359	350000
chr12	80150000	80200000	-0.021569756200000012	0.6192873741285825	50000
chr12	80200000	80700000	0.06858568413999999	0.011231603408210689	500000
chr12	80700000	81050000	-0.1072675932428571	0.061192873741285826	350000
chr12	81050000	81200000	0.03940382529999997	0.3907823392718823	150000
chr12	81200000	85850000	-0.16834756089193553	0.003098373353989156	4650000
chr12	85850000	86300000	0.030378046488888803	0.2691711851278079	450000
chr12	86300000	88400000	-0.2568230209214286	0.003098373353989156	2100000
chr12	88400000	88450000	0.25575385409999996	0.010069713400464756	50000
chr12	88450000	89400000	-0.0978510370631579	0.0038729666924864447	950000
chr12	89400000	89850000	0.039915563200000004	0.38342370255615804	450000
chr12	89850000	89900000	-0.006998017000000023	0.8292021688613478	50000
chr12	89900000	90150000	0.03963410739999995	0.38574748257164987	250000
chr12	90150000	90700000	-0.12559038862727273	0.010069713400464756	550000
chr12	90700000	90750000	0.03644853839999995	0.4163439194422928	50000
chr12	90750000	93050000	-0.132147436173913	0.017815646785437646	2300000
chr12	93050000	93300000	0.0317405489	0.465143299767622	250000
chr12	93300000	93850000	-0.01481481480000002	0.7335398915569326	550000
chr12	93850000	94500000	0.16746625730000003	0.04608830364058869	650000
chr12	94500000	94700000	-0.04507772017500003	0.05305964368706429	200000
chr12	94700000	95350000	0.03018368445384615	0.273431448489543	650000
chr12	95350000	95950000	-0.04869027059999994	0.08481797056545314	600000
chr12	95950000	96450000	-0.25364805217999997	0.010069713400464756	500000
chr12	96450000	97400000	0.04139691007894736	0.19016266460108444	950000
chr12	97400000	97800000	0.29163948055	0.0077459333849728895	400000
chr12	97800000	97950000	0.10264824412000001	0.09798605731990705	150000
chr12	97950000	98500000	-0.024493641072727276	0.5790085205267235	550000
chr12	98500000	98700000	0.055817821280000006	0.25639039504260264	200000
chr12	98700000	98850000	-0.20843088342000002	0.026723470178156468	150000
chr12	98850000	99050000	0.12436512509999997	0.07281177381874517	200000
chr12	99050000	99150000	0.29534958099999997	0.0077459333849728895	100000
chr12	99150000	99200000	0.6217744515	0.0003872966692486445	50000
chr12	99200000	99450000	0.0933793898	0.11463981409759876	250000
chr12	99450000	100000000	-0.005424422694999999	0.855151045701007	550000
chr12	100000000	100750000	0.052419881026	0.07281177381874517	750000
chr12	100750000	100950000	-0.0412140983	0.3718048024786987	200000
chr12	100950000	101100000	0.048883771500000006	0.3187451587916344	150000
chr12	101100000	101650000	-0.11737641240909093	0.032532920216886134	550000
chr12	101650000	101850000	0.07292586194999998	0.026723470178156468	200000
chr12	101850000	102100000	-0.07995266420000002	0.15608055770720372	250000
chr12	102100000	102150000	0.22128190369999998	0.019364833462432222	50000
chr12	102150000	102300000	-0.05073882169999999	0.29434546862896976	150000
chr12	102300000	102600000	0.13524595411666665	0.030983733539891558	300000
chr12	102600000	102650000	-0.19685281135000002	0.03446940356312936	50000
chr12	102650000	103400000	0.014762788116666663	0.524012393493416	750000
chr12	103400000	103900000	-0.015665579228	0.7180480247869868	500000
chr12	103900000	104550000	0.09533629553846158	0.08481797056545314	650000
chr12	104550000	104850000	-0.05295635296666671	0.2316034082106894	300000
chr12	104850000	105800000	0.08666518535263157	0.07164988381099922	950000
chr12	105800000	106350000	0.47773590825454537	0.000774593338497289	550000
chr12	106350000	106800000	0.2225740421	0.011618900077459334	450000
chr12	106800000	107350000	0.027484982199999983	0.3737412858249419	550000
chr12	107350000	107650000	0.22360071640000004	0.010069713400464756	300000
chr12	107650000	107700000	-0.0651954199	0.1924864446165763	50000
chr12	107700000	108150000	0.18995287747777778	0.003098373353989156	450000
chr12	108150000	108200000	-0.18123840589999995	0.041053446940356314	50000
chr12	108200000	109600000	0.08505405232857143	0.051897753679318356	1400000
chr12	109600000	110550000	-0.07724146293157895	0.0038729666924864447	950000
chr12	110550000	110800000	0.004292202400000056	0.8810999225406662	250000
chr12	110800000	110850000	-0.005584340799999921	0.855151045701007	50000
chr12	110850000	111300000	0.1319985501	0.053446940356312936	450000
chr12	111300000	111800000	-0.07160493828	0.04298993028659954	500000
chr12	111800000	112050000	0.14232712859999996	0.05615801704105345	250000
chr12	112050000	112900000	-0.09363375367647056	0.053446940356312936	850000
chr12	112900000	112950000	0.32850380599999995	0.0034856700232378003	50000
chr12	112950000	113600000	-0.08693542753076924	0.011618900077459334	650000
chr12	113600000	113750000	0.10740101069999997	0.08869093725793958	150000
chr12	113750000	113800000	0.39496577759999996	0.001549186676994578	50000
chr12	113800000	113900000	0.1381756541	0.06235476374903176	100000
chr12	113900000	114200000	-0.04540395316666665	0.30286599535243997	300000
chr12	114200000	115900000	0.05721964472088234	0.003098373353989156	1700000
chr12	115900000	116050000	-0.0027186080000000112	0.9372579395817195	150000
chr12	116050000	118250000	0.1099098352772727	0.022463206816421378	2200000
chr12	118250000	118400000	-0.04732936739999999	0.32378001549186675	150000
chr12	118400000	120350000	0.09807442177076924	0.0023237800154918666	1950000
chr12	120350000	121200000	-0.123602409682353	0.015879163439194422	850000
chr12	121200000	121350000	0.1581590224999999	0.04918667699457785	150000
chr12	121350000	122500000	-0.12606999128695653	0.011231603408210689	1150000
chr12	122600000	122750000	-0.05531248	0.261425251742835	150000
chr12	122800000	123300000	-0.07295592660000004	0.04918667699457785	500000
chr12	123300000	124200000	0.0757468176277777	0.06816421378776143	900000
chr12	124200000	124800000	-0.14601803878333333	0.04066615027110767	600000
chr12	124850000	125450000	-0.13071494063333336	0.02517428350116189	600000
chr12	125450000	125500000	0.18240900660000003	0.041053446940356314	50000
chr12	125500000	125650000	-0.09660333910000002	0.11463981409759876	150000
chr12	125650000	126750000	0.10793455568136366	0.000774593338497289	1100000
chr12	126750000	126800000	-0.223412013	0.018977536793183578	50000
chr12	126800000	127000000	0.16671144379999997	0.046475600309837335	200000
chr12	127000000	127400000	-0.05546600139999999	0.2594887683965918	400000
chr12	127400000	127500000	-0.472564447	0.000774593338497289	100000
chr12	127500000	127800000	-0.18120642229999995	0.041053446940356314	300000
chr12	127800000	127950000	-0.10024307559999995	0.10534469403563129	150000
chr12	127950000	128600000	0.12295292501538467	0.04608830364058869	650000
chr12	128600000	128950000	-0.039269494057142855	0.3342370255615802	350000
chr12	128950000	129250000	0.02430115773333334	0.07087529047250193	300000
chr12	129250000	131250000	-0.0635882428215	0.051897753679318356	2000000
chr12	131250000	131750000	0.07486694814000003	0.09256390395042603	500000
chr12	131800000	132100000	0.10388067971666666	0.08481797056545314	300000
chr12	132150000	132350000	0.09287404840000002	0.11773818745158791	200000
chr12	132350000	132700000	-0.09093629774285712	0.07087529047250193	350000
chr12	132900000	132950000	-0.12903153579999993	0.07087529047250193	50000
chr12	133150000	133250000	-0.12385018869999997	0.07358636715724244	100000
chr12	133250000	133850000	0.07387497604999999	0.14523625096824166	600000
chr13	19450000	20100000	0.04730112660000003	0.46782700421940926	650000
chr13	20100000	20150000	0.6333817126	0.0010548523206751054	50000
chr13	20150000	20450000	0.10885341069999999	0.12289029535864979	300000
chr13	20450000	20700000	0.020609579100000008	0.6065400843881856	250000
chr13	20700000	20900000	-0.0345566383	0.5880801687763713	200000
chr13	20900000	21550000	0.1147142165846154	0.012130801687763712	650000
chr13	21550000	21750000	-0.014002349900000044	0.8370253164556962	200000
chr13	21750000	23400000	0.06626371529696969	0.004746835443037975	1650000
chr13	23400000	23450000	-0.01607574819999999	0.8022151898734177	50000
chr13	23450000	25300000	0.08644389779189189	0.07172995780590717	1850000
chr13	25300000	25450000	-0.06322482549999997	0.3143459915611814	150000
chr13	25450000	25600000	0.04322344320000001	0.46782700421940926	150000
chr13	25600000	25750000	-0.0024051420000000268	0.9757383966244726	150000
chr13	25750000	28850000	0.12560468545322576	0.011075949367088608	3100000
chr13	28850000	28900000	-0.01183219299999999	0.8686708860759493	50000
chr13	28900000	32900000	0.122231322140625	0.002109704641350211	4000000
chr13	32900000	33350000	-0.0666067685	0.21571729957805907	450000
chr13	33350000	33650000	-0.37641854999999996	0.004219409282700422	300000
chr13	33650000	33900000	-0.022674683819999996	0.7009493670886076	250000
chr13	33900000	34400000	-0.29906420628	0.003691983122362869	500000
chr13	34400000	35050000	-0.08336443439999996	0.21571729957805907	650000
chr13	35050000	35550000	-0.24696108924	0.011075949367088608	500000
chr13	35550000	36300000	-0.11049554218000003	0.09651898734177215	750000
chr13	36300000	36550000	-0.5640058055	0.0010548523206751054	250000
chr13	36550000	36800000	-0.08090400161999997	0.17457805907172996	250000
chr13	36800000	36850000	0.20627548550000008	0.0290084388185654	50000
chr13	36850000	37000000	-0.19749809939999996	0.03322784810126582	150000
chr13	37000000	37300000	-0.023166770300000028	0.7078059071729957	300000
chr13	37300000	37350000	-0.36656299680000004	0.004746835443037975	50000
chr13	37350000	37650000	-0.07718570739999997	0.2410337552742616	300000
chr13	37650000	38150000	-0.34531619322	0.003691983122362869	500000
chr13	38150000	38300000	-0.11682908279999998	0.11392405063291139	150000
chr13	38300000	39900000	0.1172200048671875	0.011075949367088608	1600000
chr13	39900000	39950000	0.3522289032	0.006329113924050633	50000
chr13	39950000	40250000	0.19751192199999992	0.03322784810126582	300000
chr13	40250000	40300000	0.5528232772999999	0.002109704641350211	50000
chr13	40300000	41200000	0.8190652813288889	0.0005274261603375527	900000
chr13	41200000	41500000	0.4354965789000001	0.0010548523206751054	300000
chr13	41500000	41900000	0.1904485452000001	0.049578059071729956	400000
chr13	41900000	42000000	-0.005791692600000009	0.9467299578059072	100000
chr13	42000000	42800000	0.06801005595624997	0.12869198312236288	800000
chr13	42800000	42900000	-0.1474186192000001	0.0770042194092827	100000
chr13	42900000	43000000	0.5129587392999999	0.002109704641350211	100000
chr13	43000000	43450000	0.24613541594444444	0.012130801687763712	450000
chr13	43450000	43750000	0.0422005667	0.5142405063291139	300000
chr13	43750000	44350000	-0.03852834799999999	0.12078059071729957	600000
chr13	44350000	44450000	0.47831916510000005	0.0026371308016877636	100000
chr13	44450000	44800000	-0.20847328769999995	0.026371308016877638	350000
chr13	44800000	44950000	0.06991499070000007	0.2732067510548523	150000
chr13	44950000	45100000	0.1265233717666667	0.0770042194092827	150000
chr13	45100000	45900000	0.018541364274999993	0.5880801687763713	800000
chr13	45900000	46700000	0.09895638955000002	0.12289029535864979	800000
chr13	46700000	46900000	0.034777800800000036	0.5880801687763713	200000
chr13	46900000	47050000	0.45236021839999996	0.0026371308016877636	150000
chr13	47050000	47400000	0.021632455642857065	0.5147679324894515	350000
chr13	47400000	48500000	-0.296266626490909	0.0026371308016877636	1100000
chr13	48500000	48650000	0.041274448799999974	0.5147679324894515	150000
chr13	48650000	49150000	-0.04193378945000006	0.2378691983122363	500000
chr13	49150000	49350000	0.03560716009999998	0.5743670886075949	200000
chr13	49350000	51850000	-0.07192673994	0.010548523206751054	2500000
chr13	51850000	51950000	0.17301817679999998	0.06118143459915612	100000
chr13	51950000	52700000	-0.07520814618000002	0.12974683544303797	750000
chr13	52700000	52800000	0.008673716199999904	0.9235232067510548	100000
chr13	52850000	53100000	0.039442946959999906	0.20042194092827004	250000
chr13	53150000	53250000	0.0855967930999999	0.20042194092827004	100000
chr13	53250000	53300000	0.70823830257	0.0005274261603375527	50000
chr13	53300000	53550000	0.30347639776999996	0.011075949367088608	250000
chr13	53550000	54500000	0.10467460380110526	0.08438818565400844	950000
chr13	54500000	54800000	-0.06481443085000001	0.3048523206751055	300000
chr13	54800000	55850000	0.03314936037238095	0.13027426160337552	1050000
chr13	55850000	57850000	-0.09764634736274999	0.0770042194092827	2000000
chr13	57850000	58000000	0.045296841479999995	0.4778481012658228	150000
chr13	58000000	58650000	-0.07053701015846152	0.2310126582278481	650000
chr13	58650000	59000000	0.0	1.0	350000
chr13	59000000	59200000	0.0293040293	0.6381856540084389	200000
chr13	59200000	59450000	-0.08767710279999999	0.19251054852320676	250000
chr13	59450000	61100000	0.07089681804121213	0.016350210970464137	1650000
chr13	61100000	61200000	-0.23495749533000002	0.016350210970464137	100000
chr13	61200000	61500000	0.002778353719999998	0.9678270042194093	300000
chr13	61500000	61950000	-0.06011472803555556	0.11550632911392406	450000
chr13	61950000	62000000	0.009219711110000008	0.9077004219409283	50000
chr13	62000000	62400000	-0.013421798319999997	0.8417721518987342	400000
chr13	62400000	62900000	0.00874282949400001	0.9113924050632911	500000
chr13	62900000	63700000	-0.23172990525624998	0.0026371308016877636	800000
chr13	63700000	64100000	0.13209966131250003	0.07436708860759493	400000
chr13	64100000	64550000	-0.16987889814444446	0.012130801687763712	450000
chr13	64550000	64750000	-0.34603635350000006	0.006329113924050633	200000
chr13	64750000	64900000	-0.3007533347	0.011075949367088608	150000
chr13	64900000	66350000	-0.4642839268655173	0.0026371308016877636	1450000
chr13	66350000	66550000	-0.055525606500000046	0.3681434599156118	200000
chr13	66550000	66950000	-0.3564448131	0.005274261603375527	400000
chr13	66950000	67450000	-0.07853065170999998	0.011075949367088608	500000
chr13	67450000	67500000	0.08275623750000005	0.21677215189873417	50000
chr13	67500000	67800000	-0.15875319649999997	0.07172995780590717	300000
chr13	67800000	69550000	-0.38330578676382854	0.0026371308016877636	1750000
chr13	69550000	71150000	-0.06986920310975	0.07172995780590717	1600000
chr13	71150000	72800000	-0.47626377813969695	0.002109704641350211	1650000
chr13	72800000	73300000	-0.7045960328399999	0.0005274261603375527	500000
chr13	73300000	75050000	-0.1599316766114286	0.011075949367088608	1750000
chr13	75050000	75800000	-0.4791383878399999	0.0010548523206751054	750000
chr13	75800000	76450000	-0.039447731746153854	0.37658227848101267	650000
chr13	76450000	76950000	0.31629691067999993	0.004746835443037975	500000
chr13	76950000	77600000	0.10616330939230771	0.11814345991561181	650000
chr13	77600000	77650000	0.3698113208	0.004746835443037975	50000
chr13	77650000	77900000	0.1756721267	0.05590717299578059	250000
chr13	77900000	78150000	0.38595065312	0.0026371308016877636	250000
chr13	78150000	79100000	0.09659853550526316	0.07067510548523206	950000
chr13	79100000	79150000	-0.0162969107	0.7895569620253164	50000
chr13	79150000	80150000	0.17553044436350002	0.012130801687763712	1000000
chr13	80150000	80500000	-0.3506807658	0.006329113924050633	350000
chr13	80500000	81150000	0.08305714611538462	0.2120253164556962	650000
chr13	81150000	81600000	0.2877723255555556	0.006856540084388186	450000
chr13	81600000	81750000	0.05887068910000004	0.34177215189873417	150000
chr13	81750000	83150000	-0.18845363981321425	0.012130801687763712	1400000
chr13	83150000	83350000	0.13959499619999993	0.08333333333333333	200000
chr13	83350000	83750000	-0.05999032409999999	0.3333333333333333	400000
chr13	83750000	84300000	0.05656733203636358	0.12974683544303797	550000
chr13	84300000	84950000	-0.09581439365384618	0.15348101265822786	650000
chr13	84950000	85300000	0.03780496229999997	0.5479957805907173	350000
chr13	85300000	86800000	-0.31270555444000003	0.0026371308016877636	1500000
chr13	86900000	87100000	-0.40123712759999997	0.003691983122362869	200000
chr13	87100000	87300000	-0.1356693620999999	0.08649789029535865	200000
chr13	87300000	87350000	-0.33347155989999994	0.007911392405063292	50000
chr13	87350000	87500000	-0.15233948449999996	0.07489451476793249	150000
chr13	87500000	87650000	0.05278872070000007	0.3871308016877637	150000
chr13	87650000	87850000	-0.0847190545	0.08333333333333333	200000
chr13	87850000	87950000	0.1788789826	0.052742616033755275	100000
chr13	87950000	91700000	-0.3989728845572	0.002109704641350211	3750000
chr13	91700000	92100000	0.097107609375	0.052742616033755275	400000
chr13	92100000	92200000	0.2304651323	0.016350210970464137	100000
chr13	92200000	92400000	0.45024535210000005	0.0026371308016877636	200000
chr13	92400000	93350000	-0.06800091665789472	0.09651898734177215	950000
chr13	93350000	93700000	0.013490911599999933	0.8417721518987342	350000
chr13	93700000	93850000	-0.1078028888999999	0.12869198312236288	150000
chr13	93850000	94200000	0.07858179554285719	0.21571729957805907	350000
chr13	94200000	94400000	-0.023332642199999976	0.7009493670886076	200000
chr13	94400000	95050000	0.059762781976923085	0.15348101265822786	650000
chr13	95050000	95600000	-0.17386261538181813	0.01529535864978903	550000
chr13	95600000	95700000	0.06467620429999998	0.3048523206751055	100000
chr13	95700000	96000000	-0.15816573361666658	0.016350210970464137	300000
chr13	96000000	96300000	-0.3615315502	0.004746835443037975	300000
chr13	96300000	96500000	0.22351233680000004	0.02267932489451477	200000
chr13	96500000	96800000	-0.12081000759999994	0.10917721518987342	300000
chr13	96800000	97600000	0.153735572569	0.01529535864978903	800000
chr13	97600000	97750000	-0.4227244453999999	0.003691983122362869	150000
chr13	97750000	99450000	0.1241965581617647	0.052742616033755275	1700000
chr13	99450000	99500000	-0.14831709169999996	0.0770042194092827	50000
chr13	99500000	104100000	0.17535270308380432	0.002109704641350211	4600000
chr13	104100000	104450000	-0.042946990119999987	0.5100210970464135	350000
chr13	104450000	104900000	-0.39673938922666663	0.003691983122362869	450000
chr13	104900000	105600000	-0.3082076952342857	0.011075949367088608	700000
chr13	105600000	105900000	-0.40154813742	0.003691983122362869	300000
chr13	105900000	105950000	-0.19275692860000004	0.04377637130801688	50000
chr13	105950000	106550000	-0.44181353240000004	0.0026371308016877636	600000
chr13	106550000	106700000	0.05191789340000008	0.3924050632911392	150000
chr13	106700000	107250000	-0.17761106822727274	0.03270042194092827	550000
chr13	107250000	107800000	0.11411984240000002	0.11550632911392406	550000
chr13	107800000	108900000	0.31108262806363646	0.0026371308016877636	1100000
chr13	108900000	109500000	0.06124127439999999	0.25843881856540085	600000
chr13	109500000	109750000	-0.06245075680000001	0.31856540084388185	250000
chr13	109750000	109800000	0.06575437140000001	0.28744725738396626	50000
chr13	109800000	110000000	-0.20594374179999997	0.0290084388185654	200000
chr13	110000000	110100000	0.06952795630000003	0.2732067510548523	100000
chr13	110100000	110300000	-0.10263321589999996	0.1360759493670886	200000
chr13	110300000	110400000	0.13546202219999998	0.08966244725738397	100000
chr13	110400000	110850000	-0.24359051150000002	0.010548523206751054	450000
chr13	110850000	111300000	-0.04490366377777778	0.46782700421940926	450000
chr13	111300000	111650000	0.019886851714285707	0.34177215189873417	350000
chr13	111650000	111950000	0.23292556499999995	0.016350210970464137	300000
chr13	111950000	112000000	-0.030810698700000028	0.6228902953586498	50000
chr13	112000000	112350000	0.10553004949999999	0.03322784810126582	350000
chr13	112500000	113300000	0.04070124061249998	0.35390295358649787	800000
chr13	113300000	113600000	-0.09507222333333336	0.1360759493670886	300000
chr13	113600000	113800000	0.003607712999999957	0.9609704641350211	200000
chr13	113800000	114300000	-0.12236505631999997	0.08649789029535865	500000
chr13	114450000	114500000	-0.3702467344	0.004746835443037975	50000
chr14	19050000	19150000	0.08410627380000002	0.16055045871559634	100000
chr14	19400000	19500000	0.08410627380000002	0.16055045871559634	100000
chr14	20200000	20750000	-0.0297933401	0.6055045871559633	550000
chr14	20750000	20800000	0.5609402506000001	0.0011467889908256881	50000
chr14	20800000	21200000	0.006854761187499989	0.875	400000
chr14	21200000	21400000	-0.008831491599999963	0.8543577981651376	200000
chr14	21400000	21600000	0.03960117760000004	0.5068807339449541	200000
chr14	21600000	22000000	-0.028772614999999946	0.6261467889908257	400000
chr14	22000000	22050000	0.737510909951	0.0005733944954128441	50000
chr14	22050000	22700000	0.20083137325099998	0.016055045871559634	650000
chr14	22700000	22750000	0.517433689851	0.0011467889908256881	50000
chr14	22750000	22850000	-0.10708738289999997	0.1003440366972477	100000
chr14	22850000	23600000	0.09109602216000003	0.006880733944954129	750000
chr14	23600000	24800000	-0.02984634879166667	0.2901376146788991	1200000
chr14	24800000	25600000	0.098413068211875	0.02809633027522936	800000
chr14	25600000	26400000	-0.091894850503	0.00974770642201835	800000
chr14	26400000	27400000	0.08123640881500001	0.15997706422018348	1000000
chr14	27400000	29050000	-0.09219071284848486	0.0034403669724770644	1650000
chr14	29050000	29100000	0.07797452630000001	0.1926605504587156	50000
chr14	29100000	29500000	-0.08582412462499997	0.1301605504587156	400000
chr14	29500000	29650000	0.056406159866666694	0.05103211009174312	150000
chr14	29650000	31850000	-0.11711879815227268	0.0040137614678899085	2200000
chr14	31850000	31950000	0.10170268790000003	0.11410550458715596	100000
chr14	31950000	33350000	-0.036926793089285696	0.13589449541284404	1400000
chr14	33350000	33850000	0.04863089694000001	0.01834862385321101	500000
chr14	33850000	33950000	-0.3816624506	0.0034403669724770644	100000
chr14	33950000	34250000	0.004437935500000045	0.9271788990825688	300000
chr14	34250000	34300000	-0.3623574313	0.0040137614678899085	50000
chr14	34300000	34750000	0.05693871214444446	0.12270642201834862	450000
chr14	34750000	34800000	-0.2045592391	0.01548165137614679	50000
chr14	34800000	36850000	0.04535461812682928	0.016628440366972478	2050000
chr14	36850000	38100000	-0.08413733927599999	0.03669724770642202	1250000
chr14	38100000	39500000	-0.2580817974785714	0.0011467889908256881	1400000
chr14	39500000	39550000	0.13989851929999997	0.05103211009174312	50000
chr14	39550000	45350000	-0.10773190381293102	0.006307339449541285	5800000
chr14	45350000	45750000	0.07034127719999994	0.23337155963302753	400000
chr14	45750000	46950000	-0.005832186864166664	0.8772935779816514	1200000
chr14	46950000	47000000	0.011967632660000005	0.8096330275229358	50000
chr14	47000000	47150000	-0.11063773131999999	0.09518348623853211	150000
chr14	47150000	47650000	0.008136215040000006	0.8595183486238532	500000
chr14	47650000	48000000	-0.010014941050000004	0.8314220183486238	350000
chr14	48000000	48200000	0.05069601618	0.3669724770642202	200000
chr14	48200000	49500000	-0.019679398988269228	0.5986238532110092	1300000
chr14	49500000	49950000	0.04081585686222222	0.1588302752293578	450000
chr14	49950000	50050000	0.69165224336	0.0011467889908256881	100000
chr14	50050000	50750000	-0.0576815379642857	0.00974770642201835	700000
chr14	50750000	50800000	0.05313688080000001	0.34575688073394495	50000
chr14	50800000	51350000	-0.04051162668181814	0.32798165137614677	550000
chr14	51350000	51500000	0.12162901820000005	0.08314220183486239	150000
chr14	51500000	52150000	-0.04617045995384617	0.38589449541284404	650000
chr14	52150000	52600000	0.014941049400000073	0.779243119266055	450000
chr14	52600000	52950000	-0.13354170501428575	0.00974770642201835	350000
chr14	52950000	53450000	0.024837645519999986	0.49770642201834864	500000
chr14	53450000	53500000	-0.33358481630000003	0.005160550458715597	50000
chr14	53500000	53900000	0.09094439266250001	0.0625	400000
chr14	53900000	54350000	-0.025245278088888885	0.010894495412844037	450000
chr14	54350000	54600000	0.0002514829999999968	0.9856651376146789	250000
chr14	54600000	54850000	-0.03658338140000006	0.5412844036697247	250000
chr14	54850000	54900000	0.09469074980000003	0.13245412844036697	50000
chr14	54900000	55050000	-0.0853858784999999	0.15825688073394495	150000
chr14	55050000	55250000	0.026583233500000025	0.6490825688073395	200000
chr14	55250000	55450000	-0.05948312839999992	0.2952981651376147	200000
chr14	55450000	55650000	0.015177739300000104	0.779243119266055	200000
chr14	55650000	55900000	-0.04392076810000001	0.4610091743119266	250000
chr14	55900000	56200000	0.07868459589999999	0.18864678899082568	300000
chr14	56200000	56800000	-0.06808532669166666	0.05103211009174312	600000
chr14	56800000	57100000	0.0026035888000000007	0.9541284403669725	300000
chr14	57100000	57300000	-0.021993668549999998	0.16055045871559634	200000
chr14	57300000	57350000	0.0670867912	0.2511467889908257	50000
chr14	57350000	57650000	-0.06258475226666665	0.006880733944954129	300000
chr14	57650000	58500000	0.046405141723529435	0.030389908256880736	850000
chr14	58500000	58550000	-0.39972484799999997	0.0034403669724770644	50000
chr14	58550000	58950000	0.028846580600000005	0.6261467889908257	400000
chr14	58950000	59950000	-0.09661237591499998	0.014334862385321102	1000000
chr14	59950000	60000000	0.5468276158	0.0011467889908256881	50000
chr14	60000000	61250000	-0.07234959098399997	0.09690366972477064	1250000
chr14	61250000	61500000	0.03570762886000003	0.04931192660550459	250000
chr14	61500000	61700000	-0.012529771099999976	0.8073394495412844	200000
chr14	61700000	61950000	-0.2645009542	0.006880733944954129	250000
chr14	61950000	62700000	-0.06882646195999996	0.04529816513761468	750000
chr14	62700000	63100000	-0.54765603041	0.0011467889908256881	400000
chr14	63100000	63250000	-0.34299323949999994	0.005160550458715597	150000
chr14	63250000	63400000	-0.43565733219999997	0.0017201834862385322	150000
chr14	63400000	63850000	-0.3033953493999999	0.005160550458715597	450000
chr14	63850000	65300000	-0.06219281964482758	0.12270642201834862	1450000
chr14	65300000	65500000	-0.18998801749999994	0.017201834862385322	200000
chr14	65500000	65650000	-0.1631680942	0.03096330275229358	150000
chr14	65650000	65950000	0.04776204773333337	0.16055045871559634	300000
chr14	65950000	66250000	-0.09794523590000004	0.12270642201834862	300000
chr14	66250000	66300000	0.3656562966	0.0040137614678899085	50000
chr14	66300000	66550000	-0.051332120300000006	0.3532110091743119	250000
chr14	66550000	66600000	0.05211615559999999	0.34977064220183485	50000
chr14	66600000	66900000	-0.08937508936666666	0.04931192660550459	300000
chr14	66900000	67100000	0.01784050060000003	0.7505733944954128	200000
chr14	67100000	68050000	-0.10040634356842108	0.03784403669724771	950000
chr14	68050000	68300000	0.03713072679999996	0.5384174311926605	250000
chr14	68300000	68650000	-0.09705764880000001	0.1301605504587156	350000
chr14	68650000	68900000	0.022633470900000008	0.694954128440367	250000
chr14	68900000	68950000	-0.02334354059999999	0.6777522935779816	50000
chr14	68950000	69350000	0.008027115775000038	0.8314220183486238	400000
chr14	69350000	69950000	-0.013119030374999932	0.7672018348623854	600000
chr14	69950000	70250000	0.13010547490000005	0.04931192660550459	300000
chr14	70250000	70550000	0.3547537686	0.005160550458715597	300000
chr14	70550000	71050000	0.05345641212000003	0.22419724770642202	500000
chr14	71050000	71350000	-0.04919944576666673	0.03784403669724771	300000
chr14	71350000	71600000	0.10028550717999993	0.08944954128440367	250000
chr14	71600000	71750000	-0.0953564402	0.1301605504587156	150000
chr14	71750000	71800000	0.20194085709999998	0.01548165137614679	50000
chr14	71800000	72200000	0.08316691079999994	0.16055045871559634	400000
chr14	72200000	72250000	0.5544312786	0.0011467889908256881	50000
chr14	72250000	72900000	-0.032473170415384604	0.5825688073394495	650000
chr14	72900000	72950000	0.527345079	0.0011467889908256881	50000
chr14	72950000	75350000	-0.07414649875208335	0.010321100917431193	2400000
chr14	75350000	75800000	0.0727673486	0.03784403669724771	450000
chr14	75800000	76100000	-0.17239899999999997	0.02809633027522936	300000
chr14	76100000	76900000	0.13756675395	0.00974770642201835	800000
chr14	76900000	77200000	-0.01970443349999995	0.7385321100917431	300000
chr14	77200000	79200000	0.10726748916550002	0.006880733944954129	2000000
chr14	79200000	80100000	-0.06237436124333332	0.08314220183486239	900000
chr14	80100000	80250000	0.027648337990000008	0.632454128440367	150000
chr14	80250000	80600000	-0.007100696749999996	0.8772935779816514	350000
chr14	80600000	81000000	-0.34666008368999995	0.0034403669724770644	400000
chr14	81000000	81350000	-0.062057131099999996	0.27809633027522934	350000
chr14	81350000	81450000	-0.15086021989999998	0.03784403669724771	100000
chr14	81450000	81600000	-0.00909776779999999	0.8503440366972477	150000
chr14	81600000	82550000	0.09757307216421052	0.030389908256880736	950000
chr14	82550000	84300000	-0.06909400603742856	0.03727064220183486	1750000
chr14	84300000	84400000	0.012559357399999999	0.8073394495412844	100000
chr14	84400000	84900000	-0.059453542160000004	0.12270642201834862	500000
chr14	84900000	85450000	0.004778177199999997	0.9243119266055045	550000
chr14	85450000	85900000	-0.07781015823333333	0.169151376146789	450000
chr14	85900000	85950000	0.40311247210000006	0.0034403669724770644	50000
chr14	85950000	86100000	0.08127339160000002	0.16055045871559634	150000
chr14	86100000	87700000	-0.08396204087031248	0.04931192660550459	1600000
chr14	87700000	88600000	0.07364753916222222	0.15997706422018348	900000
chr14	88600000	88900000	0.2549445998	0.006880733944954129	300000
chr14	88900000	88950000	0.6757940206	0.0011467889908256881	50000
chr14	88950000	89250000	0.038684004150000034	0.23337155963302753	300000
chr14	89250000	89350000	0.18796136040000005	0.01834862385321101	100000
chr14	89350000	89850000	-0.05840618945	0.27006880733944955	500000
chr14	89850000	90000000	0.037027174900000015	0.5384174311926605	150000
chr14	90000000	90300000	-0.0015828636999999923	0.9776376146788991	300000
chr14	90300000	90350000	-0.3540732851	0.005160550458715597	50000
chr14	90350000	90500000	0.01658308559999999	0.7729357798165137	150000
chr14	90500000	90700000	-0.2150771461	0.010894495412844037	200000
chr14	90700000	91350000	0.12159715606923076	0.006880733944954129	650000
chr14	91350000	91500000	-0.10797497	0.09805045871559633	150000
chr14	91500000	91550000	0.1816003195	0.021788990825688075	50000
chr14	91550000	92000000	-0.03274867645555552	0.2901376146788991	450000
chr14	92000000	92050000	0.245580556	0.007454128440366973	50000
chr14	92050000	92300000	-0.02855071819999999	0.6261467889908257	250000
chr14	92300000	92350000	0.21855352890000007	0.010321100917431193	50000
chr14	92350000	92650000	-0.03955679823333327	0.0768348623853211	300000
chr14	92650000	93400000	0.10513469131333333	0.016628440366972478	750000
chr14	93400000	93800000	-0.08530451629999997	0.1444954128440367	400000
chr14	93800000	93850000	0.27293303160000004	0.006880733944954129	50000
chr14	93850000	94100000	-0.06214884831999997	0.13876146788990826	250000
chr14	94100000	94400000	0.006790041300000049	0.882454128440367	300000
chr14	94400000	94600000	-0.047633840699999985	0.4139908256880734	200000
chr14	94600000	94850000	0.012662909200000017	0.8073394495412844	250000
chr14	94850000	95550000	-0.05766251822857143	0.01548165137614679	700000
chr14	95550000	95600000	0.3856713857	0.0034403669724770644	50000
chr14	95600000	96500000	0.09472773261666671	0.0625	900000
chr14	96500000	96750000	0.57459134012	0.0011467889908256881	250000
chr14	96750000	97050000	0.10815248750000006	0.09805045871559633	300000
chr14	97050000	97100000	0.24608352190000005	0.007454128440366973	50000
chr14	97100000	97400000	0.014423290199999994	0.7855504587155964	300000
chr14	97400000	97650000	-0.006213109699999997	0.8962155963302753	250000
chr14	97650000	98000000	0.058713886299999976	0.30275229357798167	350000
chr14	98000000	98050000	-0.014645187099999998	0.779243119266055	50000
chr14	98050000	99250000	0.06842002100333335	0.03096330275229358	1200000
chr14	99250000	99300000	-0.16781313329999997	0.030389908256880736	50000
chr14	99300000	99900000	0.07543010990000006	0.20240825688073394	600000
chr14	99900000	99950000	0.5426115771	0.0011467889908256881	50000
chr14	99950000	100750000	-0.15778432372500006	0.016628440366972478	800000
chr14	100750000	101000000	0.06439444370000003	0.2603211009174312	250000
chr14	101000000	101350000	-0.12479474550000003	0.07110091743119266	350000
chr14	101350000	101550000	0.14004645040000008	0.05103211009174312	200000
chr14	101550000	101600000	-0.14180683149999995	0.04931192660550459	50000
chr14	101600000	101900000	0.12256098460000002	0.07855504587155963	300000
chr14	101900000	102400000	-0.019948519949999965	0.544151376146789	500000
chr14	102400000	103600000	0.03264286454583332	0.21788990825688073	1200000
chr14	103600000	104000000	-0.09322623120000001	0.021788990825688075	400000
chr14	104000000	105100000	0.02587585347272728	0.34174311926605505	1100000
chr14	105100000	105550000	-0.027648337999999995	0.632454128440367	450000
chr14	105550000	106900000	0.07868295224074073	0.007454128440366973	1350000
chr14	106900000	107300000	-0.018447018440000004	0.75	400000
chr15	20000000	20150000	-0.12512149290000002	0.06336260978670012	150000
chr15	20150000	20200000	0.01627194970000001	0.6869510664993727	50000
chr15	20200000	20250000	0.2316869695	0.011292346298619825	50000
chr15	20350000	20400000	0.2316869695	0.011292346298619825	50000
chr15	20400000	20650000	-0.05289801079999999	0.3337515683814304	250000
chr15	20800000	20900000	-0.05289801079999999	0.3337515683814304	100000
chr15	20900000	20950000	0.2395921078	0.01066499372647428	50000
chr15	21100000	21150000	0.2395921078	0.01066499372647428	50000
chr15	21150000	21250000	-0.03992256849999998	0.40464240903387705	100000
chr15	21850000	22050000	-0.04642648869999996	0.3337515683814304	200000
chr15	22150000	22200000	-0.2861319899	0.006273525721455458	50000
chr15	22250000	22600000	0.027392600300000014	0.5313676286072773	350000
chr15	22650000	22850000	-0.2943287112	0.0037641154328732747	200000
chr15	22850000	23100000	0.35535864699999997	0.0018820577164366374	250000
chr15	23100000	23300000	0.015437698400000033	0.7189460476787954	200000
chr15	23350000	23450000	0.08321454019999996	0.18318695106649938	100000
chr15	23450000	23500000	-0.3140186613	0.0037641154328732747	50000
chr15	23600000	25550000	-0.05868003460923077	0.03262233375156838	1950000
chr15	25550000	26400000	0.1750021916647059	0.002509410288582183	850000
chr15	26400000	27050000	-0.02070488314769231	0.35131744040150564	650000
chr15	27050000	28600000	0.04642439849099999	0.16499372647427854	1550000
chr15	28650000	28700000	0.056275513499999985	0.321831869510665	50000
chr15	28700000	28750000	-0.13937666040000002	0.05081555834378921	50000
chr15	28800000	28850000	-0.13937666040000002	0.05081555834378921	50000
chr15	28850000	29500000	0.045049569100000006	0.3720200752823087	650000
chr15	29500000	29950000	-0.06852739799999999	0.029485570890840654	450000
chr15	29950000	30150000	0.13330201509999995	0.053952321204516936	200000
chr15	30150000	30200000	-0.23428691770000004	0.011292346298619825	50000
chr15	30200000	30400000	0.011614721699999997	0.7760351317440402	200000
chr15	30450000	30500000	0.011614721699999997	0.7760351317440402	50000
chr15	30550000	30700000	0.03604289510000001	0.18005018820577165	150000
chr15	30750000	30800000	0.08489924190000003	0.18005018820577165	50000
chr15	30900000	31300000	0.08489924190000003	0.18005018820577165	400000
chr15	31300000	31400000	-0.2135197305	0.018820577164366373	100000
chr15	31400000	31800000	0.0938573187	0.1468005018820577	400000
chr15	31800000	32250000	-0.07075656782	0.10476787954830614	450000
chr15	32250000	32550000	0.03865904231	0.4127979924717691	300000
chr15	32600000	32650000	0.39834283681000004	0.0012547051442910915	50000
chr15	32700000	33100000	-0.03984967279999996	0.410288582183187	400000
chr15	33100000	33550000	0.12326400139999999	0.029485570890840654	450000
chr15	33550000	33850000	-0.06085984579999998	0.27352572145545795	300000
chr15	33850000	33900000	0.02609667600000004	0.5570890840652447	50000
chr15	33900000	35100000	-0.08582866258333333	0.011292346298619825	1200000
chr15	35100000	35300000	0.1261258342	0.06085319949811794	200000
chr15	35300000	35550000	-0.25510270209999997	0.010037641154328732	250000
chr15	35550000	35750000	-0.08316594317499998	0.14742785445420326	200000
chr15	35750000	36050000	-0.2789315104	0.006273525721455458	300000
chr15	36050000	36100000	-0.1600790514	0.030112923462986198	50000
chr15	36100000	37250000	-0.2880424217695653	0.0012547051442910915	1150000
chr15	37250000	37950000	-0.08451046462142857	0.09473023839397741	700000
chr15	37950000	38000000	-0.28936370111	0.0056461731493099125	50000
chr15	38000000	38250000	-0.09568781180000002	0.1355081555834379	250000
chr15	38250000	38300000	-0.45224518890000004	0.0012547051442910915	50000
chr15	38300000	38750000	0.07022289897777778	0.011292346298619825	450000
chr15	38750000	40100000	-0.18050185871111116	0.00439146800501882	1350000
chr15	40100000	40300000	0.0023326637999999678	0.9811794228356336	200000
chr15	40300000	40750000	-0.004686926266666669	0.863237139272271	450000
chr15	40750000	41000000	0.013169830900000012	0.7540777917189461	250000
chr15	41000000	41350000	-0.00659301499999998	0.8720200752823086	350000
chr15	41350000	41900000	0.1089003493090909	0.04705144291091593	550000
chr15	41900000	42050000	-0.005475280199999988	0.8920953575909661	150000
chr15	42050000	42250000	0.11517527370000002	0.08845671267252196	200000
chr15	42250000	42450000	-0.0998833668000001	0.12797992471769135	200000
chr15	42450000	43400000	0.09363735262105258	0.05834378920953576	950000
chr15	43400000	43850000	-0.008504503277777877	0.40464240903387705	450000
chr15	43850000	44050000	-0.2377535152000001	0.011292346298619825	200000
chr15	44050000	44500000	0.0174499809222222	0.15181932245922208	450000
chr15	44500000	44550000	-0.003515194700000057	0.9416562107904642	50000
chr15	44550000	45100000	0.10967643127272725	0.002509410288582183	550000
chr15	45100000	45350000	-0.14326443339999997	0.04705144291091593	250000
chr15	45350000	45500000	0.08203200930000004	0.18695106649937265	150000
chr15	45500000	45650000	-0.16712563989999998	0.029485570890840654	150000
chr15	45650000	46000000	0.13326961700000003	0.053952321204516936	350000
chr15	46000000	46650000	-0.016685025590000006	0.6856963613550816	650000
chr15	46650000	47550000	0.02344183099688889	0.4127979924717691	900000
chr15	47550000	48650000	-0.02852874302000001	0.0018820577164366374	1100000
chr15	48650000	50200000	0.050337253861290336	0.18695106649937265	1550000
chr15	50200000	50600000	-0.033155413725	0.19949811794228356	400000
chr15	50600000	51000000	0.018985291200000032	0.64366373902133	400000
chr15	51000000	51350000	-0.07192379969999996	0.2383939774153074	350000
chr15	51350000	51550000	0.05323414107499999	0.023212045169385194	200000
chr15	51550000	52000000	-0.15900451410000002	0.030112923462986198	450000
chr15	52000000	53700000	0.06194804106323528	0.04767879548306148	1700000
chr15	53700000	55450000	-0.023848247258	0.09473023839397741	1750000
chr15	55450000	55850000	0.04066772499999992	0.26537013801756587	400000
chr15	55850000	58400000	-0.06621919162156861	0.00439146800501882	2550000
chr15	58400000	58500000	0.3431769585	0.002509410288582183	100000
chr15	58500000	58850000	-0.0666591071	0.2534504391468005	350000
chr15	58850000	59200000	0.027036221100000035	0.5313676286072773	350000
chr15	59200000	59450000	-0.10001295919999997	0.12797992471769135	250000
chr15	59450000	59750000	0.04282489906666668	0.05081555834378921	300000
chr15	59750000	60450000	-0.1260066554642857	0.0018820577164366374	700000
chr15	60450000	60600000	0.012926845099999973	0.7540777917189461	150000
chr15	60600000	61350000	-0.05115985226666666	0.04077791718946048	750000
chr15	61350000	61400000	0.19399987040000002	0.02258469259723965	50000
chr15	61400000	62100000	-0.07038488947928569	0.19949811794228356	700000
chr15	62100000	62150000	0.5021382752	0.0012547051442910915	50000
chr15	62150000	62450000	0.05951532429999995	0.2810539523212045	300000
chr15	62450000	62650000	-0.13416056510000002	0.053952321204516936	200000
chr15	62650000	63400000	0.07146050672666666	0.05834378920953576	750000
chr15	63400000	63600000	0.0	1.0	200000
chr15	63600000	63800000	-0.07509881419999997	0.2164366373902133	200000
chr15	63800000	64200000	0.035556923475	0.23400250941028858	400000
chr15	64200000	64400000	-0.00440614270000006	0.9140526976160602	200000
chr15	64400000	64950000	0.01668502560000007	0.6856963613550816	550000
chr15	64950000	65750000	-0.10490507354999996	0.023212045169385194	800000
chr15	65750000	66200000	0.09360893323333341	0.05834378920953576	450000
chr15	66200000	66600000	-0.1280919945125	0.0018820577164366374	400000
chr15	66600000	66850000	0.0916056502	0.15056461731493098	250000
chr15	66850000	67300000	-0.06945074403333336	0.2383939774153074	450000
chr15	67300000	67550000	0.05429922889999994	0.32496863237139273	250000
chr15	67550000	67800000	-0.00649582059999998	0.8720200752823086	250000
chr15	67800000	68150000	0.01399598270000002	0.7409033877038896	350000
chr15	68150000	68350000	-0.23984724294999998	0.010037641154328732	200000
chr15	68350000	68500000	0.022046912500000015	0.6079046424090339	150000
chr15	68500000	68700000	-0.15138015940000005	0.035759096612296114	200000
chr15	68700000	68850000	-0.37272403290000006	0.0018820577164366374	150000
chr15	68850000	68950000	-0.14347502099999998	0.04705144291091593	100000
chr15	68950000	69000000	0.1680003888	0.029485570890840654	50000
chr15	69000000	72450000	-0.15239670872173916	0.006273525721455458	3450000
chr15	72450000	72600000	0.059639517100000004	0.15432873274780426	150000
chr15	72600000	73100000	-0.01702520569999999	0.6800501882057717	500000
chr15	73100000	73550000	0.006906196666666679	0.801129234629862	450000
chr15	73550000	73850000	-0.05280891600000002	0.3337515683814304	300000
chr15	73850000	74200000	0.027020022000000088	0.5313676286072773	350000
chr15	74200000	75100000	-0.10984848484999998	0.010037641154328732	900000
chr15	75100000	75500000	0.035635893862500004	0.4228356336260979	400000
chr15	75500000	76000000	-0.06862243240999998	0.02383939774153074	500000
chr15	76000000	76250000	0.1449005378	0.043914680050188205	250000
chr15	76250000	76450000	-0.12306421300000003	0.06587202007528231	200000
chr15	76450000	76650000	0.02804056239999997	0.5175658720200753	200000
chr15	76650000	77150000	-0.03230091359999998	0.47992471769134254	500000
chr15	77150000	77200000	0.22461608239999997	0.013801756587202008	50000
chr15	77200000	77450000	-0.22620358969999996	0.013801756587202008	250000
chr15	77450000	77800000	0.03466597550000006	0.4466750313676286	350000
chr15	77800000	80150000	-0.07688312280212765	0.002509410288582183	2350000
chr15	80150000	80500000	0.10241967581428572	0.035759096612296114	350000
chr15	80500000	81300000	-0.08036350679999998	0.023212045169385194	800000
chr15	81300000	81400000	0.19634873320000001	0.021957340025094103	100000
chr15	81400000	81700000	-0.028947709399999993	0.5131744040150564	300000
chr15	81700000	82600000	0.1134347754161111	0.006273525721455458	900000
chr15	82650000	82700000	0.24373906570000003	0.010037641154328732	50000
chr15	83150000	83400000	-0.051161472119999996	0.016938519447929738	250000
chr15	83400000	83800000	0.09429469323749998	0.04077791718946048	400000
chr15	83800000	84050000	-0.013267025200000004	0.7540777917189461	250000
chr15	84050000	84100000	0.2244378929	0.013801756587202008	50000
chr15	84100000	85000000	-0.06985122066666667	0.07779171894604768	900000
chr15	85050000	85100000	0.4475879609	0.0012547051442910915	50000
chr15	85100000	85350000	-0.030661569339999927	0.4642409033877039	250000
chr15	85350000	85650000	0.03175014579999991	0.4893350062735257	300000
chr15	85650000	85850000	-0.08728455260000001	0.018820577164366373	200000
chr15	85850000	87500000	0.0782905187321212	0.030112923462986198	1650000
chr15	87500000	88200000	-0.041858355478571425	0.198870765370138	700000
chr15	88200000	88400000	0.09682174559999995	0.1355081555834379	200000
chr15	88400000	88450000	-0.22728892630000003	0.013174404015056462	50000
chr15	88450000	89950000	0.08420214259666665	0.043914680050188205	1500000
chr15	89950000	90300000	-0.2860914922	0.006273525721455458	350000
chr15	90300000	90450000	-0.09721052289999998	0.1355081555834379	150000
chr15	90450000	90700000	-0.23641871313999996	0.006273525721455458	250000
chr15	90700000	91550000	-0.022712979470588264	0.33500627352572143	850000
chr15	91550000	91600000	0.6336259961999999	0.0006273525721455458	50000
chr15	91600000	91850000	-0.03040562429999999	0.4993726474278545	250000
chr15	91850000	91900000	0.0515615888	0.33500627352572143	50000
chr15	91900000	92150000	0.41820125701999994	0.0012547051442910915	250000
chr15	92150000	92700000	0.21898028428181818	0.011292346298619825	550000
chr15	92700000	92750000	-0.05940193100000002	0.2810539523212045	50000
chr15	92750000	92900000	0.055352167399999985	0.3237139272271016	150000
chr15	92900000	93550000	0.2263344282384616	0.010037641154328732	650000
chr15	93550000	93600000	0.88699539951	0.0006273525721455458	50000
chr15	93600000	94300000	0.04927057974214287	0.15056461731493098	700000
chr15	94300000	94350000	-0.018288731939999997	0.6499372647427855	50000
chr15	94350000	94950000	0.027574839630000004	0.3864491844416562	600000
chr15	94950000	95350000	-0.05181267414125	0.18695106649937265	400000
chr15	95350000	95550000	0.0017656968799999936	0.9843161856963614	200000
chr15	95550000	96450000	-0.10165356343555557	0.010037641154328732	900000
chr15	96450000	96550000	0.02201451430000001	0.6079046424090339	100000
chr15	96550000	96750000	-0.11732974800000001	0.07779171894604768	200000
chr15	96750000	98250000	0.07017376186000004	0.010037641154328732	1500000
chr15	98250000	98950000	-0.022685618020714293	0.3695106649937265	700000
chr15	98950000	99950000	0.10562269165500002	0.029485570890840654	1000000
chr15	99950000	100300000	-0.060651572242857096	0.2302383939774153	350000
chr15	100300000	100700000	0.07128596188750003	0.09473023839397741	400000
chr15	100700000	101100000	-0.022727272749999985	0.4127979924717691	400000
chr15	101100000	101150000	0.42690986849999996	0.0012547051442910915	50000
chr15	101150000	101600000	-0.14276226270000003	0.04705144291091593	450000
chr15	101600000	102200000	0.06668880540000001	0.09284818067754078	600000
chr15	102200000	102500000	0.28129657230000005	0.006273525721455458	300000
chr16	50000	850000	0.09071645895625	0.016139444803098774	800000
chr16	850000	1300000	-0.12619530569999993	0.09683666881859264	450000
chr16	1300000	2750000	0.0562405699413793	0.1355713363460297	1450000
chr16	2750000	3250000	-0.03969863802000005	0.028405422853453842	500000
chr16	3250000	3500000	0.0159374095	0.7682375726275016	250000
chr16	3500000	4300000	-0.089023109225	0.025177533892834086	800000
chr16	4300000	5950000	0.08975878753636363	0.010974822466107165	1650000
chr16	5950000	6150000	-0.07707910749500001	0.15687540348612009	200000
chr16	6150000	6800000	0.07620979425615383	0.0774693350548741	650000
chr16	6800000	7400000	-0.08541002607500002	0.02065848934796643	600000
chr16	7400000	7550000	0.034144692326666656	0.18398967075532602	150000
chr16	7550000	8600000	-0.07682383297857143	0.051000645577792124	1050000
chr16	8600000	9700000	0.09002002055000001	0.018076178179470628	1100000
chr16	9700000	9900000	-0.04534917419999995	0.460296965784377	200000
chr16	9900000	10150000	0.009272674500000022	0.855390574564235	250000
chr16	10150000	10300000	-0.006954506000000027	0.8870238863783085	150000
chr16	10300000	10600000	0.034192987499999994	0.5771465461588121	300000
chr16	10600000	10850000	-0.09026369170000004	0.18398967075532602	250000
chr16	10850000	11500000	0.05735238393076917	0.12524209167204647	650000
chr16	11500000	11750000	-0.3391770501	0.001936733376371853	250000
chr16	11750000	12000000	0.005360765000000045	0.9038089089735313	250000
chr16	12000000	12150000	0.37481889310000005	0.001936733376371853	150000
chr16	12150000	12550000	0.17313822080000008	0.018076178179470628	400000
chr16	12550000	12750000	0.30179658070000004	0.005164622336991607	200000
chr16	12750000	13000000	0.53332367431	0.0006455777921239509	250000
chr16	13000000	13950000	0.1034711525231579	0.025823111684958037	950000
chr16	13950000	14000000	-0.2687626775	0.005164622336991607	50000
chr16	14000000	14600000	0.10346034963333335	0.07295029051000645	600000
chr16	14600000	14800000	-0.02962909300000005	0.6087798579728857	200000
chr16	14850000	14900000	-0.08381628510000005	0.2001291155584248	50000
chr16	14900000	15250000	0.12416690819999998	0.10071013557133635	350000
chr16	15250000	15450000	-0.011156186600000007	0.8321497740477728	200000
chr16	15450000	15800000	0.0031874819000000665	0.9386701097482246	350000
chr16	15800000	16350000	-0.14206685811818182	0.005164622336991607	550000
chr16	16500000	16750000	0.01724137929999997	0.7398321497740478	250000
chr16	16750000	17200000	-0.017820921399999995	0.7398321497740478	450000
chr16	17200000	17650000	0.10040567949999996	0.14783731439638476	450000
chr16	17650000	17700000	-0.14749348020000003	0.04260813428018076	50000
chr16	17700000	18300000	0.054476963200000006	0.3673337637185281	600000
chr16	18300000	18350000	-0.3642422486	0.001936733376371853	50000
chr16	18500000	18650000	-0.36424224859999993	0.001936733376371853	150000
chr16	18700000	18750000	-0.3642422486	0.001936733376371853	50000
chr16	18750000	19150000	0.2954216169	0.005164622336991607	400000
chr16	19150000	19200000	-0.16256157629999995	0.025823111684958037	50000
chr16	19200000	19900000	0.060396572428571445	0.24531956100710137	700000
chr16	19900000	19950000	-0.2468849609	0.0071013557133634605	50000
chr16	19950000	20750000	0.15566140246875002	0.0071013557133634605	800000
chr16	20750000	20800000	-0.1795131846	0.017430600387346677	50000
chr16	20800000	20950000	0.17762967259999995	0.018076178179470628	150000
chr16	20950000	21300000	-0.03216458999999999	0.5874757908327953	350000
chr16	21300000	21400000	0.15901188060000004	0.025823111684958037	100000
chr16	21500000	21750000	0.17970153580000003	0.011620400258231117	250000
chr16	21750000	21850000	-0.0122428282	0.8063266623628147	100000
chr16	21900000	21950000	-0.0122428282	0.8063266623628147	50000
chr16	21950000	22450000	0.03944508834999999	0.4777275661717237	500000
chr16	22550000	22600000	0.39111851629999994	0.001936733376371853	50000
chr16	22600000	23050000	-0.014343668500000017	0.7830858618463525	450000
chr16	23050000	25100000	0.0562615290170732	0.02711426726920594	2050000
chr16	25100000	25300000	-0.022312373200000013	0.6804389928986443	200000
chr16	25300000	25900000	0.08026658937999999	0.22143318269851517	600000
chr16	25900000	26550000	-0.049985511448	0.4086507424144609	650000
chr16	26550000	27850000	0.13071462005499998	0.005164622336991607	1300000
chr16	27850000	28350000	-0.11619820340000005	0.025823111684958037	500000
chr16	28450000	28650000	-0.2684729064	0.005164622336991607	200000
chr16	28800000	29050000	-0.06548826429999999	0.2950290510006456	250000
chr16	29050000	29450000	0.0003622139000000191	0.9967721110393802	400000
chr16	29550000	29650000	0.015140539000000008	0.7830858618463525	100000
chr16	29650000	29800000	-0.1340191249	0.08586184635248548	150000
chr16	29800000	30150000	0.06586082708571428	0.011620400258231117	350000
chr16	30150000	30200000	-0.14771080849999996	0.040025823111684955	50000
chr16	30300000	30350000	-0.14771080849999996	0.040025823111684955	50000
chr16	30350000	32100000	0.03430061678000001	0.010974822466107165	1750000
chr16	32100000	32350000	-0.061503911899999986	0.3105229180116204	250000
chr16	32350000	32700000	0.004998551099999998	0.9038089089735313	350000
chr16	32800000	33000000	0.004998551099999998	0.9038089089735313	200000
chr16	33000000	33100000	-0.1501738627	0.03357004519044545	100000
chr16	33200000	34050000	0.02033511170588236	0.5067785668173015	850000
chr16	34150000	34500000	-0.08316430017	0.2078760490639122	350000
chr16	34500000	35300000	0.016344900027875	0.6939961265332473	800000
chr16	46350000	46600000	0.06244566789999999	0.3105229180116204	250000
chr16	46600000	47200000	-0.06451028687499998	0.06068431245965139	600000
chr16	47200000	47450000	0.033584468259999986	0.18657198192382182	250000
chr16	47450000	47800000	-0.07026948709999992	0.26404131697869593	350000
chr16	47800000	48050000	-0.3097652855	0.003873466752743706	250000
chr16	48050000	48350000	-0.08533758324999996	0.09489993544222079	300000
chr16	48350000	48650000	0.17922341350000004	0.017430600387346677	300000
chr16	48650000	48700000	-0.43422196469999996	0.0012911555842479018	50000
chr16	48700000	49100000	0.08301941463	0.2078760490639122	400000
chr16	49100000	49450000	-0.03462764416	0.5603615235635894	350000
chr16	49450000	50400000	0.11611432228421048	0.001936733376371853	950000
chr16	50400000	50750000	-0.019414662400000005	0.7159457714654616	350000
chr16	50750000	51400000	0.1387892026968461	0.001936733376371853	650000
chr16	51400000	51800000	-0.001448855403999999	0.974176888315042	400000
chr16	51800000	52050000	0.043813387459999985	0.018076178179470628	250000
chr16	52050000	52300000	-0.023616343129999995	0.6559070367979342	250000
chr16	52300000	53950000	0.08300185277757578	0.010974822466107165	1650000
chr16	53950000	55450000	-0.05158891139999998	0.003873466752743706	1500000
chr16	55450000	55500000	0.2848449725	0.005164622336991607	50000
chr16	55500000	55900000	-0.019468994475000008	0.632020658489348	400000
chr16	55900000	55950000	0.01666183710000002	0.7398321497740478	50000
chr16	55950000	58500000	-0.11666126895686274	0.001936733376371853	2550000
chr16	58500000	58750000	0.039843523599999986	0.4945125887669464	250000
chr16	58750000	59450000	-0.11532889010000001	0.11491284699806327	700000
chr16	59450000	59750000	0.06288032459999998	0.3105229180116204	300000
chr16	59750000	59800000	-0.05896841489999999	0.3318269851517108	50000
chr16	59800000	60250000	0.08749476802222224	0.08973531310522918	450000
chr16	60250000	63300000	-0.05751718437459019	0.016139444803098774	3050000
chr16	63300000	63600000	0.08483048384999999	0.18657198192382182	300000
chr16	63600000	64350000	-0.06340191252533334	0.025177533892834086	750000
chr16	64350000	65100000	0.04286680189466667	0.3976759199483538	750000
chr16	65100000	65400000	-0.019704433500000004	0.7088444157520981	300000
chr16	65400000	65500000	0.0	1.0	100000
chr16	65500000	65950000	0.03641456582666666	0.4777275661717237	450000
chr16	65950000	66350000	-0.13387423932	0.08586184635248548	400000
chr16	66350000	66400000	0.7358736598000001	0.0006455777921239509	50000
chr16	66400000	67500000	0.017880192822727296	0.55390574564235	1100000
chr16	67500000	68900000	-0.07192014737857141	0.05422853453841188	1400000
chr16	68900000	69050000	0.10373804689999999	0.13879922530664945	150000
chr16	69050000	69100000	-0.06374963779999998	0.3105229180116204	50000
chr16	69100000	69450000	0.08889762801428569	0.1736604260813428	350000
chr16	69450000	70100000	-0.03719100373076925	0.2950290510006456	650000
chr16	70100000	70250000	-0.3107794843	0.003873466752743706	150000
chr16	70250000	70850000	0.038962136583333334	0.16074887023886378	600000
chr16	70850000	71700000	-0.053761058205882346	0.18398967075532602	850000
chr16	71700000	72150000	0.11672945036666668	0.08973531310522918	450000
chr16	72150000	72500000	-0.0211118930571429	0.5997417688831505	350000
chr16	72500000	72800000	0.11793682989999998	0.11362169141381537	300000
chr16	72800000	72850000	-0.08403361340000004	0.2001291155584248	50000
chr16	72850000	74750000	0.0815286187357895	0.001936733376371853	1900000
chr16	74750000	75000000	-0.12981744420000002	0.08973531310522918	250000
chr16	75000000	75700000	0.15126050419999998	0.010974822466107165	700000
chr16	75700000	76150000	-0.12083454070000002	0.1039380245319561	450000
chr16	76150000	77400000	0.06098522165559998	0.2537120723047127	1250000
chr16	77400000	77650000	-0.08446827010000002	0.2001291155584248	250000
chr16	77650000	78000000	0.08653806355714287	0.18398967075532602	350000
chr16	78000000	78200000	-0.03955375250000001	0.49580374435119434	200000
chr16	78200000	78250000	0.12793393223	0.09360877985797289	50000
chr16	78250000	78750000	-0.011445957693999998	0.5958683021304068	500000
chr16	78750000	79000000	0.07389162566000002	0.23563589412524208	250000
chr16	79000000	79350000	0.23715693173142857	0.005164622336991607	350000
chr16	79350000	79600000	0.09127789039999998	0.1736604260813428	250000
chr16	79600000	79900000	0.30389742111666673	0.003873466752743706	300000
chr16	79900000	80350000	0.07374674000000003	0.23563589412524208	450000
chr16	80350000	80400000	0.2658649666	0.005164622336991607	50000
chr16	80400000	80550000	0.017965807	0.7398321497740478	150000
chr16	80550000	81000000	-0.04042306570000004	0.4945125887669464	450000
chr16	81000000	81150000	0.06737177629999991	0.2750161394448031	150000
chr16	81150000	82600000	-0.042361534372413814	0.16655907036797934	1450000
chr16	82600000	82650000	0.1561866126	0.025823111684958037	50000
chr16	82650000	83800000	-0.1819888375304348	0.01355713363460297	1150000
chr16	83800000	83850000	0.19849319039999996	0.016139444803098774	50000
chr16	83850000	86600000	-0.1115697689763636	0.005164622336991607	2750000
chr16	86600000	87400000	0.01603701823125	0.6481601032924468	800000
chr16	87400000	87750000	-0.06689572385714285	0.2317624273724984	350000
chr16	87750000	88100000	0.05791282024285714	0.3105229180116204	350000
chr16	88100000	88700000	-0.05215879456666669	0.06068431245965139	600000
chr16	88700000	88950000	0.07751376413999993	0.18657198192382182	250000
chr16	88950000	89250000	-0.18791654590000006	0.016139444803098774	300000
chr16	89250000	89300000	0.17342799190000002	0.018076178179470628	50000
chr16	89300000	90200000	-0.009212305677777723	0.7843770174306004	900000
chr17	0	300000	0.07973070745000001	0.0501628664495114	300000
chr17	400000	700000	0.15917599270000002	0.0501628664495114	300000
chr17	700000	900000	-0.0446055199	0.5087947882736157	200000
chr17	900000	1700000	0.07825381334999996	0.05472312703583062	800000
chr17	1700000	1950000	-0.05183400380000003	0.45342019543973944	250000
chr17	1950000	2650000	0.04933063267857143	0.01758957654723127	700000
chr17	2650000	3450000	-0.027393066250000028	0.6091205211726385	800000
chr17	3450000	3500000	0.5138197459	0.0006514657980456026	50000
chr17	3500000	3800000	0.0446254331	0.5087947882736157	300000
chr17	3800000	4000000	-0.060416583700000026	0.36612377850162864	200000
chr17	4000000	4300000	0.09753474849999999	0.1517915309446254	300000
chr17	4300000	4600000	-0.23560609079999995	0.007817589576547232	300000
chr17	4600000	5450000	0.07063438702352942	0.05472312703583062	850000
chr17	5450000	5950000	-0.030383527900000006	0.007817589576547232	500000
chr17	5950000	6000000	0.002728105399999986	0.9446254071661238	50000
chr17	6000000	6300000	-0.0020112311000000105	0.9602605863192183	300000
chr17	6300000	7850000	0.09055614293870964	0.07687296416938111	1550000
chr17	7850000	8000000	-0.16424389660000005	0.046905537459283386	150000
chr17	8000000	8650000	0.14125949325384612	0.007817589576547232	650000
chr17	8650000	8700000	-0.08570632039999998	0.19087947882736156	50000
chr17	8700000	9500000	0.16347101639375	0.007817589576547232	800000
chr17	9500000	10700000	-0.04977298976270833	0.20716612377850163	1200000
chr17	10700000	10750000	0.013381655999999992	0.8254071661237785	50000
chr17	10750000	11150000	-0.0812607033125	0.16742671009771987	400000
chr17	11150000	11250000	0.028137321330000006	0.6846905537459284	100000
chr17	11250000	11850000	-0.043291250149999995	0.536156351791531	600000
chr17	11850000	12850000	0.034459755474	0.15700325732899023	1000000
chr17	12850000	13200000	-0.04421579060857144	0.4058631921824104	350000
chr17	13200000	15450000	0.048840831756222225	0.007817589576547232	2250000
chr17	15450000	15750000	-0.0229798081	0.7276872964169381	300000
chr17	15750000	15800000	-0.43056274650000004	0.0026058631921824105	50000
chr17	15800000	16450000	0.014815404799999987	0.8110749185667753	650000
chr17	16450000	16700000	-0.13737305347999998	0.016938110749185668	250000
chr17	16700000	17200000	0.0072284837800000055	0.8514657980456026	500000
chr17	17200000	17600000	-0.15040921578749994	0.003908794788273616	400000
chr17	17600000	18300000	0.013710223399999999	0.8110749185667753	700000
chr17	18400000	18850000	-0.13616631480000002	0.06710097719869706	450000
chr17	18850000	18950000	0.21467402130000002	0.016938110749185668	100000
chr17	19100000	19300000	0.13825222035	0.016938110749185668	200000
chr17	19300000	20350000	-0.08494677496190475	0.026058631921824105	1050000
chr17	20450000	20800000	-0.042464853199999986	0.5478827361563517	350000
chr17	20800000	21500000	0.09008437500714285	0.016938110749185668	700000
chr17	21500000	21600000	-0.01566171492	0.8026058631921824	100000
chr17	21650000	22050000	-0.01566171492	0.8026058631921824	400000
chr17	22050000	22300000	0.01318252419999999	0.8254071661237785	250000
chr17	25250000	25550000	0.04611892151	0.495114006514658	300000
chr17	25550000	25650000	0.38225337526	0.003908794788273616	100000
chr17	25650000	25950000	-0.020590226599999983	0.749185667752443	300000
chr17	25950000	27300000	0.029981871592592576	0.3537459283387622	1350000
chr17	27300000	28250000	-0.06454594810526315	0.09446254071661238	950000
chr17	28250000	28800000	-0.3699053942909092	0.003908794788273616	550000
chr17	28800000	29700000	-0.05799160105555561	0.1517915309446254	900000
chr17	29700000	30300000	0.0671870644	0.2768729641693811	600000
chr17	30300000	30500000	-0.09667848179999994	0.1517915309446254	200000
chr17	30500000	30800000	0.027380620500000008	0.6846905537459284	300000
chr17	30800000	30850000	0.6008403361	0.0006514657980456026	50000
chr17	30850000	31400000	0.06569900687636364	0.2768729641693811	550000
chr17	31400000	31700000	0.0	0.9993485342019544	300000
chr17	31700000	32700000	-0.045971563979	0.21498371335504887	1000000
chr17	32700000	34200000	0.06021944324	0.06188925081433225	1500000
chr17	34200000	34500000	-0.3113624596	0.006514657980456026	300000
chr17	34800000	34850000	0.09199888490000002	0.15895765472312703	50000
chr17	34850000	35000000	-0.22790632840000002	0.014332247557003257	150000
chr17	35000000	35350000	-0.3616745276142858	0.003908794788273616	350000
chr17	35350000	35950000	-0.16956237465833326	0.012377850162866449	600000
chr17	35950000	36000000	0.2085905453000001	0.01758957654723127	50000
chr17	36000000	36800000	-0.23066430359999998	0.007817589576547232	800000
chr17	36800000	36850000	0.05276992320000007	0.43127035830618893	50000
chr17	36850000	37050000	-0.032538133699999916	0.650814332247557	200000
chr17	37050000	37250000	-0.32293201639999997	0.005863192182410423	200000
chr17	37250000	38100000	-0.05814882402352941	0.19087947882736156	850000
chr17	38100000	38450000	0.028535584799999958	0.6768729641693811	350000
chr17	38450000	38800000	0.1829025448285714	0.003908794788273616	350000
chr17	38800000	41150000	-0.12099416758510635	0.005863192182410423	2350000
chr17	41150000	41450000	0.002137347833333303	0.904885993485342	300000
chr17	41450000	41600000	-0.018758214200000012	0.7635179153094462	150000
chr17	41600000	42150000	-0.32795556829999994	0.003908794788273616	550000
chr17	42150000	42850000	-0.05303448387142857	0.39543973941368077	700000
chr17	42850000	43600000	0.06336373407333337	0.05472312703583062	750000
chr17	43650000	43700000	0.4411067744	0.0013029315960912053	50000
chr17	43700000	44100000	-0.05679238520000002	0.39543973941368077	400000
chr17	44100000	44350000	0.06111354499999999	0.36156351791530944	250000
chr17	44350000	44400000	-0.119558724	0.098371335504886	50000
chr17	44550000	44600000	-0.119558724	0.098371335504886	50000
chr17	44750000	45100000	-0.09696864529999992	0.1237785016286645	350000
chr17	45100000	45400000	0.026345135300000044	0.6859934853420195	300000
chr17	45400000	46900000	-0.08975267828999997	0.0026058631921824105	1500000
chr17	46900000	46950000	0.21366840580000002	0.016938110749185668	50000
chr17	46950000	48100000	-0.20151963524782615	0.007817589576547232	1150000
chr17	48100000	48500000	0.04976303322499995	0.13355048859934854	400000
chr17	48500000	49050000	-0.02633427345454551	0.0762214983713355	550000
chr17	49050000	49250000	0.04916563780000005	0.46970684039087945	200000
chr17	49250000	49350000	0.68423672786	0.0006514657980456026	100000
chr17	49350000	49950000	-0.038452347767999995	0.5973941368078176	600000
chr17	49950000	51800000	0.050955132917891895	0.13355048859934854	1850000
chr17	51800000	51900000	-0.06117328448	0.3537459283387622	100000
chr17	51900000	52950000	0.024872508245571433	0.6749185667752443	1050000
chr17	52950000	53450000	-0.04477279063999999	0.1517915309446254	500000
chr17	53450000	53600000	0.12296387743333337	0.05472312703583062	150000
chr17	53600000	54200000	-0.037257557059999995	0.3732899022801303	600000
chr17	54200000	54400000	0.26934565295	0.007817589576547232	200000
chr17	54400000	55150000	0.10716741675333333	0.03973941368078176	750000
chr17	55150000	55350000	0.21056194990000002	0.016938110749185668	200000
chr17	55350000	55750000	0.5428232904500001	0.0006514657980456026	400000
chr17	55750000	55900000	0.16057987180000005	0.0501628664495114	150000
chr17	55900000	56100000	0.2363893425	0.012377850162866449	200000
chr17	56100000	56600000	0.046411645269999996	0.23713355048859935	500000
chr17	56600000	57050000	-0.07206358056666667	0.15700325732899023	450000
chr17	57050000	57300000	0.028527619559999984	0.2964169381107492	250000
chr17	57300000	57650000	-0.2062009638	0.01758957654723127	350000
chr17	57650000	59550000	0.03758245626052634	0.0996742671009772	1900000
chr17	59550000	60500000	-0.07529382418421054	0.03973941368078176	950000
chr17	60500000	60800000	0.005535863600000024	0.9042345276872964	300000
chr17	60800000	61200000	-0.2530367598	0.007817589576547232	400000
chr17	61200000	61500000	0.051415827000000025	0.4560260586319218	300000
chr17	61500000	61950000	-0.006480633344444474	0.860586319218241	450000
chr17	61950000	62150000	-0.2585925365	0.007817589576547232	200000
chr17	62150000	62800000	0.08023479169999993	0.10488599348534201	650000
chr17	62800000	62950000	-0.01927595680000005	0.7635179153094462	150000
chr17	62950000	63200000	0.21171691429999995	0.016938110749185668	250000
chr17	63200000	63600000	-0.02645465770000001	0.24299674267100976	400000
chr17	63600000	64150000	0.033349143218181825	0.28859934853420194	550000
chr17	64150000	64200000	0.4894858417	0.0006514657980456026	50000
chr17	64200000	64550000	0.17668963319999995	0.03908794788273615	350000
chr17	64550000	64750000	-0.04440638809999997	0.05472312703583062	200000
chr17	64750000	65350000	0.09102645798333335	0.07687296416938111	600000
chr17	65350000	65700000	0.3745782673285714	0.003908794788273616	350000
chr17	65700000	65900000	0.10179616880000003	0.1276872964169381	200000
chr17	65900000	66200000	-0.04712453699999994	0.19087947882736156	300000
chr17	66200000	66500000	0.130272014	0.07687296416938111	300000
chr17	66500000	66550000	0.4952009238999999	0.0006514657980456026	50000
chr17	66550000	66750000	0.012007646600000005	0.8371335504885994	200000
chr17	66750000	67000000	0.12656816279999994	0.07687296416938111	250000
chr17	67000000	70100000	-0.1520698785306452	0.014332247557003257	3100000
chr17	70100000	70150000	0.08058863360000001	0.20716612377850163	50000
chr17	70150000	70350000	-0.13742084509999997	0.06579804560260587	200000
chr17	70350000	70550000	0.05165478509999999	0.4560260586319218	200000
chr17	70550000	70700000	-0.0005177426000000374	0.9758957654723127	150000
chr17	70700000	72950000	0.13790097396044443	0.03908794788273615	2250000
chr17	72950000	73650000	-0.06448882874999996	0.014332247557003257	700000
chr17	73650000	74350000	0.10264674589285717	0.11856677524429968	700000
chr17	74350000	74750000	-0.015193755199999992	0.8110749185667753	400000
chr17	74750000	74800000	0.30234178980000004	0.007817589576547232	50000
chr17	74800000	75050000	-0.05059938669999997	0.45993485342019547	250000
chr17	75050000	75500000	0.11125492859999997	0.1022801302931596	450000
chr17	75500000	75750000	-0.0606555419	0.36612377850162864	250000
chr17	75750000	76400000	0.10768434237692305	0.07882736156351791	650000
chr17	76400000	76450000	-0.1679079215	0.03973941368078176	50000
chr17	76450000	77550000	0.11290953263181817	0.0006514657980456026	1100000
chr17	77600000	78300000	0.04456427118571428	0.14332247557003258	700000
chr17	78300000	79000000	-0.08308347030714273	0.03908794788273615	700000
chr17	79000000	79650000	0.06631394810769226	0.05472312703583062	650000
chr17	79650000	79700000	-0.016806722700000054	0.7928338762214984	50000
chr17	79700000	79800000	-0.3613445378	0.003908794788273616	100000
chr17	79800000	80250000	-0.008403361299999967	0.8762214983713354	450000
chr17	80250000	80600000	-0.09989019304285715	0.11074918566775244	350000
chr17	80600000	81150000	0.16669864843636364	0.010423452768729642	550000
chr18	50000	300000	0.03836490351999997	0.38098449089683073	250000
chr18	300000	650000	-0.13429901028571437	0.07956844234659474	350000
chr18	650000	850000	0.15662755899999992	0.08091706001348618	200000
chr18	850000	900000	-0.45524458720000005	0.0013486176668914363	50000
chr18	900000	1950000	0.10060331397142858	0.10991233985165205	1050000
chr18	1950000	2000000	-0.28585785760000004	0.004720161834120027	50000
chr18	2000000	2800000	0.10507608531874997	0.09575185434929198	800000
chr18	2800000	3250000	-0.05197856957777774	0.048550236008091704	450000
chr18	3250000	4700000	0.11502540006172408	0.0013486176668914363	1450000
chr18	4700000	4950000	-0.0509274432	0.47741065407956845	250000
chr18	4950000	5450000	0.08669244720000001	0.18138907619689817	500000
chr18	5450000	5650000	0.26518974900000003	0.004720161834120027	200000
chr18	5650000	5950000	0.1093050185	0.12407282535401214	300000
chr18	5950000	6100000	0.43044722639999994	0.0013486176668914363	150000
chr18	6100000	6350000	0.1945555045	0.03641267700606878	250000
chr18	6350000	6450000	-0.0017915273999999926	0.9797707349966285	100000
chr18	6450000	7000000	0.039369906709090914	0.29871881321645316	550000
chr18	7000000	7100000	-0.032684450899999995	0.6574511126095752	100000
chr18	7100000	7500000	0.013196128500000015	0.8287255563047876	400000
chr18	7500000	8600000	-0.12495406980909092	0.004720161834120027	1100000
chr18	8600000	10600000	0.025639597152499992	0.06810519217801753	2000000
chr18	10650000	11200000	0.08682353452727269	0.048550236008091704	550000
chr18	11200000	11300000	-0.046000742799999994	0.5198921105866486	100000
chr18	11300000	11550000	0.18687596949999996	0.037761294672960216	250000
chr18	11550000	11600000	-0.04143453269999997	0.5832771409305462	50000
chr18	11650000	11750000	-0.04143453269999997	0.5832771409305462	100000
chr18	11750000	12050000	0.026308506833333373	0.34861766689143625	300000
chr18	12050000	13150000	-0.043536896100000014	0.2380310182063385	1100000
chr18	13150000	14250000	0.06902494832272729	0.02899527983816588	1100000
chr18	14300000	14350000	0.043542854600000014	0.545515846257586	50000
chr18	14550000	14600000	-0.03864892620000002	0.6183412002697235	50000
chr18	14650000	14850000	-0.05539533760000001	0.4308833445718139	200000
chr18	14900000	15000000	-0.00799632950000001	0.9035738368172623	100000
chr18	15050000	15100000	-0.00799632950000001	0.9035738368172623	50000
chr18	15150000	15200000	-0.00799632950000001	0.9035738368172623	50000
chr18	15300000	15350000	-0.00799632950000001	0.9035738368172623	50000
chr18	18500000	18750000	0.09682987050000003	0.16520566419420094	250000
chr18	18750000	19050000	-0.19826964680000003	0.033041132838840186	300000
chr18	19050000	19150000	0.002643595200000015	0.9629130141604855	100000
chr18	19150000	20600000	-0.06999010818275864	0.09575185434929198	1450000
chr18	20600000	21100000	0.043064385749999975	0.3385030343897505	500000
chr18	21100000	21250000	-0.018264840199999965	0.7923128792987189	150000
chr18	21250000	21800000	0.0	1.0	550000
chr18	21800000	22350000	0.12666615024545455	0.004045853000674309	550000
chr18	22350000	22850000	-0.016477682380000004	0.74645987862441	500000
chr18	22850000	23500000	0.10346658872307692	0.10654079568442347	650000
chr18	23500000	23550000	-0.32321775789999996	0.0033715441672285905	50000
chr18	23550000	23950000	0.11490354151250001	0.03641267700606878	400000
chr18	23950000	24000000	-0.10406152370000005	0.13823331085637222	50000
chr18	24000000	24550000	0.009541571563636357	0.7970330411328388	550000
chr18	24550000	25400000	-0.07503209713999999	0.10586648685097774	850000
chr18	25400000	25750000	0.025331073642857138	0.29871881321645316	350000
chr18	25750000	27500000	-0.1393783337628571	0.037761294672960216	1750000
chr18	27500000	29050000	-0.35388163095161296	0.0006743088334457181	1550000
chr18	29050000	29300000	-0.09836359259999997	0.05529332434254889	250000
chr18	29300000	30250000	0.10859323707894739	0.09575185434929198	950000
chr18	30250000	31000000	-0.046970061088000024	0.13823331085637222	750000
chr18	31000000	31250000	0.022730549908000004	0.6534052596089008	250000
chr18	31250000	31650000	-0.022577068460000002	0.4261631827376939	400000
chr18	31650000	32050000	0.0678158659	0.32906271072151044	400000
chr18	32050000	32200000	-0.24797360780000002	0.010114632501685773	150000
chr18	32200000	32500000	0.14316197300000003	0.04383007417397168	300000
chr18	32500000	32550000	-0.09866509359999998	0.15913688469318948	50000
chr18	32550000	33500000	0.06770202693684213	0.0020229265003371545	950000
chr18	33500000	34050000	-0.029840252181818152	0.015509103169251517	550000
chr18	34050000	34400000	0.04133621729999992	0.5832771409305462	350000
chr18	34400000	34450000	0.5006663607999999	0.0006743088334457181	50000
chr18	34450000	35150000	-0.01476917704999997	0.7889413351314902	700000
chr18	35150000	36250000	0.0690611959540909	0.08024275118004046	1100000
chr18	36250000	36350000	-0.08243210767	0.2231962238705327	100000
chr18	36350000	37400000	0.04647983596666666	0.29130141604855025	1050000
chr18	37400000	39050000	-0.09943970082454548	0.007417397167902899	1650000
chr18	39050000	39700000	0.03341887624	0.24814565070802427	650000
chr18	39700000	40250000	-0.10744596125727272	0.11193526635198921	550000
chr18	40250000	40650000	0.0034519674000000056	0.9629130141604855	400000
chr18	40650000	41150000	-0.09007450128000001	0.05529332434254889	500000
chr18	41150000	41650000	0.0406654869	0.4207687120701281	500000
chr18	41650000	42050000	-0.164514649	0.07956844234659474	400000
chr18	42050000	42100000	0.2190469948	0.02157788267026298	50000
chr18	42100000	42250000	-0.08717310089999997	0.20633850303438975	150000
chr18	42250000	43550000	0.050335869400000025	0.02899527983816588	1300000
chr18	43550000	43700000	-0.006729151699999991	0.9190829399865138	150000
chr18	43700000	43850000	0.2659981211	0.004720161834120027	150000
chr18	43850000	44200000	-0.11299731270000002	0.10991233985165205	350000
chr18	44200000	45250000	0.11356119648571425	0.02899527983816588	1050000
chr18	45250000	45300000	-0.36828996519999996	0.0013486176668914363	50000
chr18	45300000	46250000	0.06907729441578951	0.0020229265003371545	950000
chr18	46250000	46950000	-0.011518522342857163	0.6614969656102495	700000
chr18	46950000	47050000	0.1265867033	0.10519217801753203	100000
chr18	47050000	47400000	-0.060627908499999994	0.38503034389750507	350000
chr18	47400000	48300000	0.048703812983333344	0.10991233985165205	900000
chr18	48300000	48350000	-0.13427716239999998	0.09777478084962914	50000
chr18	48350000	48800000	0.2116187104888889	0.004720161834120027	450000
chr18	48800000	48850000	-0.24408468250000004	0.010114632501685773	50000
chr18	48850000	49200000	0.07170479120000002	0.29871881321645316	350000
chr18	49200000	49500000	-0.16348779796666665	0.044504383007417395	300000
chr18	49500000	50250000	0.021593002846666664	0.6695886716115981	750000
chr18	50250000	50450000	-0.010175657069999998	0.6311530681051922	200000
chr18	50450000	51800000	0.07946807656592593	0.015509103169251517	1350000
chr18	51800000	51950000	-0.10700006550000002	0.1301416048550236	150000
chr18	51950000	52100000	0.029363570900000024	0.6891436277815239	150000
chr18	52200000	52650000	0.020391368677777782	0.6311530681051922	450000
chr18	52650000	52900000	-0.1841340587	0.04383007417397168	250000
chr18	52900000	52950000	0.025911603399999983	0.7181389076196898	50000
chr18	52950000	53550000	-0.06997880750000002	0.09777478084962914	600000
chr18	53550000	54250000	-0.4513665858142858	0.0006743088334457181	700000
chr18	54250000	55200000	-0.06774802252105261	0.12407282535401214	950000
chr18	55200000	55250000	0.45563784930000006	0.0013486176668914363	50000
chr18	55250000	55500000	0.010661772800000024	0.8658125421443021	250000
chr18	55500000	55850000	-0.03631120139999999	0.6190155091031693	350000
chr18	55850000	57100000	0.05725546742799995	0.037761294672960216	1250000
chr18	57100000	57650000	-0.07292827340909093	0.10586648685097774	550000
chr18	57650000	58350000	-0.24532533079285715	0.0006743088334457181	700000
chr18	58350000	59200000	0.060437703305882336	0.21780175320296696	850000
chr18	59200000	60400000	-0.13989935404999995	0.004720161834120027	1200000
chr18	60400000	60650000	0.023508334999999936	0.7370195549561699	250000
chr18	60650000	61650000	-0.12507264425999992	0.02899527983816588	1000000
chr18	61650000	61700000	0.6205457604	0.0006743088334457181	50000
chr18	61700000	63850000	-0.04006802316900001	0.14565070802427513	2150000
chr18	63850000	64100000	0.01433221909	0.8219824679703304	250000
chr18	64100000	64500000	-0.033088636899999996	0.5367498314227916	400000
chr18	64500000	64850000	0.03823381619999999	0.6183412002697235	350000
chr18	64850000	66400000	-0.04541120205806452	0.031018206338503034	1550000
chr18	66400000	66850000	0.20029179082222226	0.0013486176668914363	450000
chr18	66850000	67400000	-0.004172947900000001	0.9514497639919083	550000
chr18	67400000	67550000	-0.3965174455	0.0013486176668914363	150000
chr18	67550000	67950000	0.256450591	0.007417397167902899	400000
chr18	67950000	68100000	-0.011491992700000009	0.8455832771409305	150000
chr18	68100000	68150000	0.78276638046	0.0006743088334457181	50000
chr18	68150000	68750000	-0.03915142776000001	0.6183412002697235	600000
chr18	68750000	69200000	0.020371948297777782	0.5124747134187457	450000
chr18	69200000	70250000	-0.06258277491009526	0.09777478084962914	1050000
chr18	70250000	71100000	0.09433535490617648	0.09035738368172623	850000
chr18	71100000	71600000	-0.04362587665999999	0.17329737019554955	500000
chr18	71600000	72150000	0.0924880978909091	0.09035738368172623	550000
chr18	72150000	72400000	-0.015577549099999977	0.803776129467296	250000
chr18	72400000	72700000	0.08920495510000004	0.19892110586648684	300000
chr18	72700000	72750000	-0.11627449699999992	0.10991233985165205	50000
chr18	72750000	73050000	0.1277446418	0.10519217801753203	300000
chr18	73050000	73300000	-0.10324441244000002	0.07619689817936615	250000
chr18	73300000	74050000	0.03600241784666667	0.2380310182063385	750000
chr18	74050000	74250000	-0.0383649036	0.6183412002697235	200000
chr18	74250000	74500000	0.004697297399999967	0.9318948078219824	250000
chr18	74500000	74900000	0.12487164365000003	0.08091706001348618	400000
chr18	74900000	74950000	0.6109326866	0.0006743088334457181	50000
chr18	74950000	75400000	0.0310240108	0.6695886716115981	450000
chr18	75400000	76450000	-0.028236843671428553	0.11193526635198921	1050000
chr18	76450000	77950000	0.08543692145333334	0.004720161834120027	1500000
chr18	77950000	78050000	-0.13823163140000005	0.09575185434929198	100000
chr19	250000	7300000	0.011594596897057758	0.0018050541516245488	7050000
chr19	7400000	8850000	0.011594596897057758	0.0018050541516245488	1450000
chr19	8900000	20500000	0.011594596897057758	0.0018050541516245488	11600000
chr19	20600000	24600000	0.011594596897057758	0.0018050541516245488	4000000
chr19	27700000	37750000	0.011594596897057758	0.0018050541516245488	10050000
chr19	37800000	48400000	0.011594596897057758	0.0018050541516245488	10600000
chr19	48450000	59100000	0.011594596897057758	0.0018050541516245488	10650000
chr2	0	550000	0.09175919610000002	0.105285502016557	550000
chr2	550000	600000	-0.13016019479999996	0.07111016769263426	50000
chr2	600000	3350000	0.17363109100000007	0.00191042241562301	2750000
chr2	3350000	3650000	-0.004683332300000065	0.9163659520271704	300000
chr2	3650000	3700000	0.4559580671	0.0012736149437486733	50000
chr2	3700000	4150000	0.0876070033	0.15623009976650393	450000
chr2	4150000	4250000	-0.036063209459999995	0.4956484822755254	100000
chr2	4250000	4550000	0.048576649519999994	0.07259605179367438	300000
chr2	4550000	4950000	-0.04289048444	0.2003820844831246	400000
chr2	4950000	5050000	0.03544871589999998	0.5026533644661431	100000
chr2	5100000	5200000	0.03544871589999998	0.5026533644661431	100000
chr2	5200000	5450000	-0.017160846040000004	0.6909361069836553	250000
chr2	5450000	6200000	0.06420481566666666	0.07981320314158352	750000
chr2	6200000	6850000	-0.037893419019230774	0.2428359159414137	650000
chr2	6850000	9900000	0.0964403674685246	0.0016981532583315645	3050000
chr2	9900000	10250000	-0.0003566776000000216	0.9915092337083422	350000
chr2	10250000	10800000	0.037503313009090954	0.35576310762046276	550000
chr2	10800000	11100000	-0.0642097264833334	0.10592230948843133	300000
chr2	11100000	11300000	0.1617377954	0.03842071746975165	200000
chr2	11300000	11800000	-0.059933471849999975	0.15538102313733815	500000
chr2	11800000	13150000	0.14177433045185184	0.007217151347909149	1350000
chr2	13150000	13650000	-0.011378016189999984	0.0950965824665676	500000
chr2	13650000	14000000	0.12244510264285716	0.05773721078327319	350000
chr2	14000000	14050000	-0.057805036999999976	0.28911059223094887	50000
chr2	14050000	15250000	0.037375712053333336	0.24028868605391637	1200000
chr2	15250000	15300000	-0.23551578683000002	0.013160687752069624	50000
chr2	15300000	15750000	0.2831012344	0.007853958819783485	450000
chr2	15750000	15800000	0.1767182557	0.029929951178093824	50000
chr2	15800000	15950000	0.3414412877000001	0.00382084483124602	150000
chr2	15950000	16350000	0.1031462261875	0.07450647420929739	400000
chr2	16350000	16400000	0.20232925999999998	0.0191042241562301	50000
chr2	16400000	16700000	0.14248883440000001	0.05667586499681596	300000
chr2	16700000	16950000	0.3301694994	0.0025472298874973467	250000
chr2	16950000	17700000	0.08801873330733333	0.039694332413500316	750000
chr2	17700000	17800000	0.48582981829000005	0.0010613457864572277	100000
chr2	17800000	20500000	-0.1743778100425926	0.0014858841010401188	2700000
chr2	20500000	21950000	0.1119636199358621	0.0036085756739545746	1450000
chr2	21950000	22400000	-0.048491357039999995	0.20059435364041606	450000
chr2	22400000	22600000	0.0061604429	0.8925918064105286	200000
chr2	22600000	23150000	-0.006451917601818179	0.7879431118658459	550000
chr2	23150000	23550000	0.05387770611375001	0.061558055614519214	400000
chr2	23550000	23950000	-0.018744959900000024	0.7132243684992571	400000
chr2	23950000	24000000	0.03843589110000001	0.46295903205264277	50000
chr2	24000000	24100000	-0.06506265119999999	0.2451708766716196	100000
chr2	24100000	24350000	0.19690543389999993	0.022925068987476118	250000
chr2	24350000	24450000	-0.013200949100000026	0.7898535342814689	100000
chr2	24450000	26100000	0.06825324763030305	0.029929951178093824	1650000
chr2	26100000	26350000	-0.008820017300000038	0.8550201655699426	250000
chr2	26350000	26600000	0.012638794100000017	0.80322649119083	250000
chr2	26600000	26700000	-0.24002078040000008	0.012736149437486733	100000
chr2	26700000	26800000	-0.08404410400000006	0.16429632774357886	100000
chr2	26800000	26850000	-0.27646392910000006	0.008278497134366377	50000
chr2	26850000	27050000	-0.05970860990000004	0.2757376353215878	200000
chr2	27050000	27200000	-0.3004000993	0.0070048821906177035	150000
chr2	27200000	27550000	-0.05162908629999996	0.3260454255996604	350000
chr2	27550000	27650000	0.11695536880000001	0.08830396943324136	100000
chr2	27650000	27900000	-0.012782240499999986	0.7970706856293781	250000
chr2	27900000	28000000	0.17495425220000005	0.030779027807259607	100000
chr2	28000000	29150000	-0.051184082082608676	0.1649331352154532	1150000
chr2	29150000	29450000	0.013848396500000026	0.787518573551263	300000
chr2	29450000	30100000	0.4747701278461537	0.0004245383145828911	650000
chr2	30100000	30350000	0.26018857389999994	0.010188919549989387	250000
chr2	30350000	30400000	-0.041560697199999996	0.4379112714922522	50000
chr2	30400000	32500000	0.21145103180238095	0.007217151347909149	2100000
chr2	32500000	32900000	-0.028913179949999993	0.44555296115474424	400000
chr2	32900000	33000000	0.0354312698	0.5026533644661431	100000
chr2	33000000	33250000	-0.05632404940000002	0.29420505200594355	250000
chr2	33250000	33350000	0.2083036102	0.017830609212481426	100000
chr2	33350000	33600000	0.08439690469999994	0.16344725111441308	250000
chr2	33600000	33650000	0.28847853729999995	0.007217151347909149	50000
chr2	33650000	33850000	0.019861515999999968	0.704096794735725	200000
chr2	33850000	34100000	0.3806409342	0.0027594990447887924	250000
chr2	34100000	34400000	0.16985608835	0.026109106346847804	300000
chr2	34400000	35100000	0.03875241472857142	0.105285502016557	700000
chr2	35100000	35200000	-0.011541622799999984	0.8161749097856081	100000
chr2	35200000	35600000	0.0685780581	0.2213967310549777	400000
chr2	35600000	36050000	-0.07396925335555554	0.11356399915092337	450000
chr2	36050000	36150000	0.062410830599999995	0.25875610273827215	100000
chr2	36150000	36800000	-0.0961997728769231	0.04563786881766079	650000
chr2	36800000	36850000	0.07072297010000006	0.2171513479091488	50000
chr2	36850000	37300000	-0.08934214516666664	0.05985990235618765	450000
chr2	37300000	37350000	0.07925997139999996	0.1827637444279346	50000
chr2	37350000	38050000	-0.0712485711142857	0.15028656336234344	700000
chr2	38050000	38100000	0.17656705539999995	0.029929951178093824	50000
chr2	38100000	40000000	-0.15030074780263156	0.0036085756739545746	1900000
chr2	40000000	41300000	0.1856788863269231	0.009339842920823604	1300000
chr2	41300000	42050000	0.41621771810000013	0.0006368074718743367	750000
chr2	42050000	42350000	-0.08071769743333333	0.05306728932286139	300000
chr2	42350000	42550000	0.0735376217	0.20229250689874761	200000
chr2	42550000	43450000	-0.10660331760000005	0.004457652303120356	900000
chr2	43450000	43800000	0.009874542499999972	0.836552748885587	350000
chr2	43800000	45100000	-0.06555830185769233	0.03651029505412864	1300000
chr2	45100000	45150000	0.1609934247	0.0405434090426661	50000
chr2	45150000	45850000	-0.04927440475714283	0.16429632774357886	700000
chr2	45850000	46150000	0.0369587804	0.47909148800679263	300000
chr2	46150000	46900000	-0.05064072737333338	0.20016981532583317	750000
chr2	46900000	47150000	0.019846008399999948	0.704096794735725	250000
chr2	47150000	47650000	-0.016233484300000055	0.1458289110592231	500000
chr2	47650000	48800000	0.08099565648695652	0.01570791763956697	1150000
chr2	48800000	48850000	-0.13773571740000007	0.05985990235618765	50000
chr2	48850000	49200000	0.32873658582000004	0.004457652303120356	350000
chr2	49200000	49550000	0.05745999007000001	0.2916578221184462	350000
chr2	49550000	50000000	-0.01897757584	0.7132243684992571	450000
chr2	50000000	50700000	0.08752364928	0.010613457864572278	700000
chr2	50700000	55400000	-0.12082768015180849	0.0027594990447887924	4700000
chr2	55400000	55650000	0.013534365100000056	0.7879431118658459	250000
chr2	55650000	55900000	-0.08102319956	0.14901294841859478	250000
chr2	55900000	56250000	-0.4406364369000001	0.0014858841010401188	350000
chr2	56250000	56850000	-0.23678742014666668	0.008703035448949268	600000
chr2	56850000	58200000	-0.10286071536296294	0.03481214179579707	1350000
chr2	58200000	58500000	0.09784080798333326	0.0070048821906177035	300000
chr2	58500000	58800000	-0.07151774090000002	0.2152409254935258	300000
chr2	58800000	58950000	0.07741842929999998	0.1882827425175122	150000
chr2	58950000	59000000	-0.1366773153	0.05985990235618765	50000
chr2	59000000	60900000	0.09302450382789475	0.017830609212481426	1900000
chr2	60900000	60950000	-0.3525525712	0.0031840373593716833	50000
chr2	60950000	64400000	0.10724759046811594	0.006792613033326258	3450000
chr2	64400000	64850000	-0.06376517173333332	0.14922521757588622	450000
chr2	64850000	65100000	0.15030472674	0.007217151347909149	250000
chr2	65100000	65250000	-0.17244975490000003	0.031628104436425386	150000
chr2	65250000	65700000	0.05645457275555553	0.07535555083846317	450000
chr2	65700000	65800000	-0.24385118790000004	0.011250265336446614	100000
chr2	65800000	66650000	0.0765182972882353	0.0025472298874973467	850000
chr2	66650000	67850000	-0.0671413321958333	0.007217151347909149	1200000
chr2	67850000	68050000	0.02992602820000001	0.5756739545744003	200000
chr2	68050000	68350000	-0.061786644700000004	0.2651241774570155	300000
chr2	68350000	68550000	0.12496898450000005	0.07450647420929739	200000
chr2	68550000	68600000	-0.14098846229999995	0.05667586499681596	50000
chr2	68600000	69200000	0.13368561713333335	0.010613457864572278	600000
chr2	69200000	69250000	-0.33399758079999997	0.00382084483124602	50000
chr2	69250000	70300000	0.023279307366666693	0.05306728932286139	1050000
chr2	70300000	70550000	-0.05625814159999998	0.2948418594778179	250000
chr2	70550000	71550000	0.01470519818499998	0.07450647420929739	1000000
chr2	71550000	72450000	-0.12005002103888884	0.02441095308851624	900000
chr2	72450000	72500000	0.10520439180000007	0.1122903842071747	50000
chr2	72500000	73500000	-0.021468697645	0.5756739545744003	1000000
chr2	73500000	73550000	0.32090906269999997	0.005518998089577585	50000
chr2	73550000	73950000	-0.01685689470000007	0.7401825514752707	400000
chr2	73950000	74450000	0.0372883195999999	0.4750583740182551	500000
chr2	74450000	74600000	-0.30699863540000005	0.0063680747187433665	150000
chr2	74600000	75200000	0.05806737590000005	0.2003820844831246	600000
chr2	75200000	75700000	-0.07610802680000006	0.1971980471237529	500000
chr2	75700000	75900000	0.02502171079999993	0.6497558904691149	200000
chr2	75900000	75950000	0.72181471373	0.00021226915729144556	50000
chr2	75950000	76400000	-0.014887413939999995	0.768414349395033	450000
chr2	76400000	78650000	0.03748612920822224	0.08724262364678412	2250000
chr2	78650000	79000000	-0.033983513070000006	0.44555296115474424	350000
chr2	79000000	79700000	0.02879174900571429	0.2171513479091488	700000
chr2	79700000	80000000	-0.020462440289999998	0.6947569518149013	300000
chr2	80000000	80200000	0.01175873086000001	0.8110804500106135	200000
chr2	80200000	81150000	-0.03566368157263158	0.21290596476331988	950000
chr2	81150000	81600000	0.017328587966666666	0.5066864784546805	450000
chr2	81600000	81750000	-0.09322079897000002	0.1458289110592231	150000
chr2	81750000	81800000	0.02922818063	0.5828911059223095	50000
chr2	81800000	82650000	-0.05967964693788235	0.17469751645085968	850000
chr2	82650000	82750000	0.20115454993999998	0.020377839099978774	100000
chr2	82750000	83950000	-0.036358340834999996	0.18149012948418594	1200000
chr2	83950000	86050000	0.09944982661238094	0.008278497134366377	2100000
chr2	86050000	86250000	-0.27410675509999993	0.008703035448949268	200000
chr2	86250000	86450000	-0.01080888279999992	0.8270006368074718	200000
chr2	86450000	87150000	0.07852210847142858	0.11568669072383783	700000
chr2	87300000	87400000	0.05372165959999997	0.20059435364041606	100000
chr2	87750000	87800000	-0.16941993370000002	0.03438760348121418	50000
chr2	88250000	88300000	-0.16941993370000002	0.03438760348121418	50000
chr2	88300000	89550000	0.186861159312	0.00912757376353216	1250000
chr2	89800000	89900000	0.02668879099999999	0.6230099766503927	100000
chr2	89950000	90300000	0.0529278581	0.3179791976225854	350000
chr2	90450000	90500000	0.008717278800000006	0.8562937805136913	50000
chr2	91650000	92200000	0.11245601445454546	0.014222033538526852	550000
chr2	92250000	92350000	0.09625837414999999	0.08066227977074931	100000
chr2	95300000	95900000	0.12332371210833332	0.07280832095096583	600000
chr2	95900000	95950000	-0.196339402	0.02334960730205901	50000
chr2	95950000	96100000	0.03105421500000005	0.561239651878582	150000
chr2	96150000	96250000	0.03105421500000005	0.561239651878582	100000
chr2	96300000	96350000	0.03105421500000005	0.561239651878582	50000
chr2	96350000	96850000	-0.07333834750000001	0.15028656336234344	500000
chr2	96850000	97000000	0.03614462500000004	0.4956484822755254	150000
chr2	97000000	97200000	-0.09025106997499999	0.029929951178093824	200000
chr2	97200000	97650000	0.054081029600000025	0.010825727021863723	450000
chr2	97650000	97900000	-0.0042491161000000055	0.9252812566334112	250000
chr2	98000000	98050000	-0.006435705000000014	0.890469114837614	50000
chr2	98150000	98250000	-0.006435705000000014	0.890469114837614	100000
chr2	98250000	98600000	0.08556607617142856	0.1122903842071747	350000
chr2	98600000	98700000	-0.13242044539999998	0.06877520696242836	100000
chr2	98700000	98950000	0.1255970474	0.07280832095096583	250000
chr2	98950000	99050000	-0.09960998069999999	0.1290596476331989	100000
chr2	99050000	100750000	0.0767928752147059	0.010613457864572278	1700000
chr2	100750000	101350000	-0.18304152972499999	0.02334960730205901	600000
chr2	101350000	101600000	0.014092643199999921	0.7828486520908512	250000
chr2	101600000	101850000	-0.24838331996	0.005518998089577585	250000
chr2	101850000	103100000	0.13464378762800003	0.007217151347909149	1250000
chr2	103100000	104900000	-0.006371520246055557	0.561239651878582	1800000
chr2	104900000	106700000	0.07131258659855558	0.02441095308851624	1800000
chr2	106700000	106850000	0.28436123690000004	0.007853958819783485	150000
chr2	106850000	107450000	0.16339518325	0.02759499044788792	600000
chr2	107450000	108200000	0.5379444254866667	0.0004245383145828911	750000
chr2	108200000	108450000	0.18747867690000003	0.02441095308851624	250000
chr2	108500000	108550000	0.39010258360000005	0.0027594990447887924	50000
chr2	108550000	109050000	0.10885258359999997	0.10146465718531097	500000
chr2	109050000	109150000	0.7218844985	0.00021226915729144556	100000
chr2	109150000	109750000	0.10750179633333333	0.061558055614519214	600000
chr2	109750000	110150000	0.20446351032500001	0.00955211207811505	400000
chr2	110250000	110500000	0.08535411881999999	0.00955211207811505	250000
chr2	110850000	111000000	0.0465483686	0.1001910422415623	150000
chr2	111350000	111450000	0.014633475000000007	0.7737210783273191	100000
chr2	111450000	111850000	-0.1269888655	0.07280832095096583	400000
chr2	111850000	112000000	0.10238198619999994	0.11589895988112928	150000
chr2	112000000	112050000	-0.33342573359999994	0.004457652303120356	50000
chr2	112150000	112250000	-0.33342573359999994	0.004457652303120356	100000
chr2	112250000	112300000	-0.05749488250000001	0.2916578221184462	50000
chr2	112350000	112500000	-0.05749488250000001	0.2916578221184462	150000
chr2	112550000	112650000	-0.05749488250000001	0.2916578221184462	100000
chr2	112650000	112850000	0.054207245199999976	0.3141583527913394	200000
chr2	112850000	113250000	-0.07601110350000001	0.05667586499681596	400000
chr2	113250000	113700000	0.010587897800000023	0.8286987900658035	450000
chr2	113700000	113900000	-0.3729025804999999	0.0029717682020802376	200000
chr2	113900000	114200000	-0.02449832519999995	0.6506049670982806	300000
chr2	114200000	114750000	0.09530658769999999	0.14285714285714285	550000
chr2	114750000	115550000	-0.019456376776875	0.3837826363829336	800000
chr2	115550000	116000000	0.005940750157777777	0.32158777329654004	450000
chr2	116000000	117800000	-0.03258969494066668	0.12099341965612397	1800000
chr2	117800000	120400000	0.10276170175375	0.029929951178093824	2600000
chr2	120400000	120600000	-0.053935860099999955	0.3150074294205052	200000
chr2	120600000	120950000	0.11807580169999998	0.08724262364678412	350000
chr2	120950000	121800000	-0.06484212221176466	0.05901082572702186	850000
chr2	121800000	121850000	0.3391267602	0.00382084483124602	50000
chr2	121850000	122100000	-0.01725621860000004	0.7321163234981957	250000
chr2	122100000	123000000	0.12959265518333332	0.021651454043727446	900000
chr2	123000000	123050000	-0.09933084176	0.13012099341965613	50000
chr2	123050000	123650000	0.014371782145000003	0.7756315007429421	600000
chr2	123650000	125050000	-0.04505381180128572	0.13033326257694758	1400000
chr2	125050000	125800000	0.02590668486333333	0.4563786881766079	750000
chr2	125800000	126000000	-0.054602692140000006	0.30906389301634474	200000
chr2	126000000	126550000	0.010275628640000003	0.5654850350244109	550000
chr2	126550000	127000000	-0.04336734693666666	0.2651241774570155	450000
chr2	127000000	128300000	0.12418912504923078	0.012736149437486733	1300000
chr2	128300000	128450000	-0.21932701653333334	0.008703035448949268	150000
chr2	128450000	130800000	0.08261161934308511	0.0063680747187433665	2350000
chr2	130850000	131200000	0.135380482	0.061558055614519214	350000
chr2	131450000	132000000	0.16268570497272725	0.007217151347909149	550000
chr2	132050000	132150000	0.01288497919999998	0.7962216090002122	100000
chr2	132150000	132350000	0.1903495441	0.02334960730205901	200000
chr2	132350000	133000000	0.08029034036923077	0.1598386754404585	650000
chr2	133000000	133050000	0.6060146703	0.0004245383145828911	50000
chr2	133050000	133350000	0.17452778990000006	0.030779027807259607	300000
chr2	133350000	133500000	-0.01206113139999998	0.8110804500106135	150000
chr2	133500000	133700000	-0.321901557	0.004882190617703248	200000
chr2	133700000	133850000	-0.15280534709999993	0.04436425387391212	150000
chr2	133850000	134000000	-0.37000651330000006	0.0029717682020802376	150000
chr2	134000000	134450000	-0.5906913170555556	0.0004245383145828911	450000
chr2	134450000	134600000	-0.36813783270000006	0.0029717682020802376	150000
chr2	134600000	134650000	0.0633490478	0.2540861812778603	50000
chr2	134650000	134850000	-0.14143818619999998	0.05667586499681596	200000
chr2	134850000	135250000	0.0330392035	0.5410740819358947	400000
chr2	135250000	135700000	-0.19420967475555553	0.002334960730205901	450000
chr2	135700000	136200000	0.08764654796	0.12099341965612397	500000
chr2	136200000	136250000	0.29931455869999996	0.0070048821906177035	50000
chr2	136250000	136450000	0.004853917299999955	0.9138187221396731	200000
chr2	136450000	136650000	0.26930711500000004	0.0031840373593716833	200000
chr2	136650000	136750000	0.11886669569999997	0.08639354701761834	100000
chr2	136750000	137150000	0.40146780595200005	0.0012736149437486733	400000
chr2	137150000	137650000	0.08431355067499999	0.09297389089365315	500000
chr2	137650000	138650000	-0.118592208912	0.0027594990447887924	1000000
chr2	138650000	139250000	0.22571361373333335	0.010613457864572278	600000
chr2	139250000	139500000	0.4126527510999999	0.002334960730205901	250000
chr2	139500000	139600000	0.2663761553	0.009339842920823604	100000
chr2	139600000	140250000	0.5526478244	0.0004245383145828911	650000
chr2	140250000	140800000	0.11291701677272727	0.03714710252600297	550000
chr2	140800000	142950000	-0.1973687722	0.0031840373593716833	2150000
chr2	142950000	143050000	0.03458609889999997	0.5130545531734239	100000
chr2	143050000	144650000	-0.294521824204375	0.0010613457864572277	1600000
chr2	144650000	145100000	0.057763683066666585	0.016132455954149864	450000
chr2	145100000	147900000	-0.15186436061446426	0.004457652303120356	2800000
chr2	147900000	149700000	0.1314308588305556	0.008066227977074932	1800000
chr2	149750000	149900000	0.09495572540000002	0.14285714285714285	150000
chr2	149900000	150400000	-0.050985515775000004	0.13309276162173636	500000
chr2	150400000	150700000	0.054668599999999956	0.30906389301634474	300000
chr2	150700000	150900000	-0.035756932000000075	0.49883251963489705	200000
chr2	150900000	152350000	0.09074517818275858	0.08066227977074931	1450000
chr2	152350000	152950000	-0.23869422390833336	0.004882190617703248	600000
chr2	152950000	156150000	0.06546676064562501	0.0452133305030779	3200000
chr2	156150000	156650000	-0.13043157995	0.030779027807259607	500000
chr2	156650000	157150000	-0.32021509214999994	0.005518998089577585	500000
chr2	157150000	157450000	0.023928416399999985	0.6533644661430694	300000
chr2	157450000	158150000	-0.04507347335714287	0.13012099341965613	700000
chr2	158150000	158350000	-0.39674570440000007	0.0025472298874973467	200000
chr2	158350000	158750000	-0.0823624853	0.14497983443005732	400000
chr2	158750000	158800000	0.17821087410000003	0.029929951178093824	50000
chr2	158800000	159300000	-0.3709912535999999	0.0029717682020802376	500000
chr2	159300000	159750000	-0.21444079150000006	0.01570791763956697	450000
chr2	159750000	160100000	-0.010254481799999993	0.8337932498407982	350000
chr2	160100000	160150000	0.12094085349999995	0.07981320314158352	50000
chr2	160150000	161300000	-0.026827686308695663	0.3251963489704946	1150000
chr2	161300000	162000000	0.07573085679285715	0.01103799617915517	700000
chr2	162000000	162200000	-0.04223140619999999	0.43218000424538316	200000
chr2	162200000	162300000	0.12978025560000006	0.07111016769263426	100000
chr2	162300000	163150000	-0.13865044494705883	0.02334960730205901	850000
chr2	163150000	163200000	0.2758009739	0.008278497134366377	50000
chr2	163200000	164400000	-0.2090728578875	0.011250265336446614	1200000
chr2	164400000	164450000	0.14372557529999996	0.05518998089577584	50000
chr2	164450000	167950000	-0.18847682038714286	0.0016981532583315645	3500000
chr2	167950000	168400000	0.17686945590000003	0.029929951178093824	450000
chr2	168400000	168800000	-0.10097853736249998	0.029929951178093824	400000
chr2	168800000	169000000	0.2484414739	0.01103799617915517	200000
chr2	169000000	169300000	-0.13171096705	0.01570791763956697	300000
chr2	169300000	169500000	0.06343821719999998	0.2530248354914031	200000
chr2	169500000	169750000	-0.15996603810000004	0.04075567819995755	250000
chr2	169750000	170000000	-0.3301788041	0.004457652303120356	250000
chr2	170000000	170300000	-0.023257707399999994	0.6629165782211844	300000
chr2	170300000	171050000	0.16084868593333335	0.010825727021863723	750000
chr2	171050000	171550000	-0.015115377380000017	0.7401825514752707	500000
chr2	171550000	171750000	0.17196513869999996	0.032052642751008276	200000
chr2	171750000	171800000	0.5482949259	0.0004245383145828911	50000
chr2	171800000	172050000	0.0424640221	0.42963277435788577	250000
chr2	172050000	173400000	-0.07684062314074074	0.022925068987476118	1350000
chr2	173400000	173600000	0.030848737599999954	0.5633623434514965	200000
chr2	173600000	173900000	-0.15631396939999997	0.04266610061558056	300000
chr2	173900000	174100000	0.02731685379999993	0.6168541710889408	200000
chr2	174100000	174400000	-0.06416320330000003	0.2511144130757801	300000
chr2	174400000	174550000	0.07679424359999998	0.19358947144979835	150000
chr2	174550000	174950000	-0.08068862045	0.05773721078327319	400000
chr2	174950000	175150000	0.08752558779999997	0.15623009976650393	200000
chr2	175150000	175250000	-0.044123348399999984	0.41625981744852475	100000
chr2	175250000	176100000	0.10338930407647057	0.01528337932498408	850000
chr2	176100000	176550000	-0.06142695173333333	0.16323498195712163	450000
chr2	176550000	176900000	0.09810407010000004	0.04266610061558056	350000
chr2	176900000	176950000	-0.07349109859999997	0.20229250689874761	50000
chr2	176950000	177050000	0.20044507159999997	0.020377839099978774	100000
chr2	177050000	177250000	0.050299298999999964	0.34514964975589046	200000
chr2	177250000	177500000	0.29096597612	0.0027594990447887924	250000
chr2	177500000	178200000	0.05845359198571427	0.2315856506049671	700000
chr2	178200000	178500000	0.41333896780000007	0.0021226915729144554	300000
chr2	178500000	178650000	-0.182405713	0.02759499044788792	150000
chr2	178650000	178950000	0.014387289900000017	0.7756315007429421	300000
chr2	178950000	179000000	0.6673128218	0.0004245383145828911	50000
chr2	179000000	179450000	0.2212486817999999	0.014222033538526852	450000
chr2	179450000	179500000	-0.29337897780000005	0.0070048821906177035	50000
chr2	179500000	179600000	-0.004749240099999996	0.9163659520271704	100000
chr2	179600000	179650000	-0.2656821847	0.009339842920823604	50000
chr2	179650000	180600000	0.06230350084210525	0.035448949267671406	950000
chr2	180600000	180800000	-0.2745836177	0.008278497134366377	200000
chr2	180800000	180950000	0.05121425469999996	0.3285926554871577	150000
chr2	180950000	181800000	-0.0869360662235294	0.013160687752069624	850000
chr2	181800000	182250000	0.042223221577777775	0.42963277435788577	450000
chr2	182250000	182550000	-0.0859050308	0.1621736361706644	300000
chr2	182550000	182950000	0.05480816945000007	0.009339842920823604	400000
chr2	182950000	184050000	-0.1553741661136364	0.0036085756739545746	1100000
chr2	184050000	184100000	0.2647323367	0.00955211207811505	50000
chr2	184100000	184200000	-0.16744851439999997	0.03523668011037996	100000
chr2	184200000	185000000	-0.35644912888424996	0.0014858841010401188	800000
chr2	185000000	186400000	-0.14697292015000002	0.016769263426024198	1400000
chr2	186400000	186550000	0.013871658100000017	0.787518573551263	150000
chr2	186550000	186900000	-0.04443737980000001	0.403523668011038	350000
chr2	186900000	187350000	0.06859453509999996	0.22542984504351518	450000
chr2	187350000	187550000	-0.022904906700000005	0.6656760772659732	200000
chr2	187550000	187600000	0.319660691	0.005518998089577585	50000
chr2	187600000	188300000	-0.12337224287142859	0.03714710252600297	700000
chr2	188300000	188350000	0.22148905160000004	0.014222033538526852	50000
chr2	188350000	189300000	-0.10308677141578945	0.04563786881766079	950000
chr2	189300000	190300000	0.09723477920000004	0.010613457864572278	1000000
chr2	190300000	190500000	-0.3098791948	0.0063680747187433665	200000
chr2	190500000	190700000	-0.0651983438	0.2428359159414137	200000
chr2	190700000	190750000	0.1505450963999999	0.04563786881766079	50000
chr2	190750000	191150000	-0.09546554190000006	0.14179579707068563	400000
chr2	191150000	192050000	0.0258800201555555	0.2829547866694969	900000
chr2	192050000	192100000	-0.16324979839999998	0.03651029505412864	50000
chr2	192100000	192300000	0.025579988900000017	0.6444491615368287	200000
chr2	192300000	192600000	-0.06458966560000001	0.2502653364466143	300000
chr2	192600000	192850000	0.0022369890000000225	0.953300785395882	250000
chr2	192850000	192950000	-0.09882684080000004	0.13309276162173636	100000
chr2	192950000	193150000	0.13295158489999992	0.06644024623222246	200000
chr2	193150000	196150000	-0.2396633273293333	0.0025472298874973467	3000000
chr2	196150000	196300000	0.22320265490000005	0.014222033538526852	150000
chr2	196300000	196950000	-0.09332428320769232	0.08066227977074931	650000
chr2	196950000	197200000	0.010080019899999959	0.8359159414137126	250000
chr2	197200000	197650000	-0.1643939237333333	0.02441095308851624	450000
chr2	197650000	197900000	0.01742680359999993	0.730842708554447	250000
chr2	197900000	198700000	-0.050098667881250065	0.11865845892591806	800000
chr2	198700000	198750000	0.23700065129999998	0.012736149437486733	50000
chr2	198750000	199150000	-0.040924880600000005	0.44067077053704096	400000
chr2	199150000	200350000	0.10097643732916668	0.0010613457864572277	1200000
chr2	200350000	202050000	-0.06677021114411763	0.1458289110592231	1700000
chr2	202050000	202500000	0.026805098900000046	0.6189768626618553	450000
chr2	202500000	202750000	-0.049754202640000036	0.1001910422415623	250000
chr2	202750000	203100000	-0.31651262329999996	0.005518998089577585	350000
chr2	203100000	203250000	-0.08114028279999996	0.17682020802377416	150000
chr2	203250000	203500000	0.07974924006000006	0.013585226066652516	250000
chr2	203500000	203650000	-0.12424012159999998	0.07450647420929739	150000
chr2	203650000	204400000	0.04701915724666663	0.02334960730205901	750000
chr2	204400000	204700000	-0.0030899138000000104	0.9320738696667374	300000
chr2	204700000	205250000	0.055330850245454546	0.11356399915092337	550000
chr2	205250000	205300000	-0.009048756200000008	0.8497134366376565	50000
chr2	205300000	207150000	0.26906255394054057	0.0027594990447887924	1850000
chr2	207150000	207900000	-0.09151029717999995	0.1006155805561452	750000
chr2	207900000	207950000	0.39258963460000007	0.0027594990447887924	50000
chr2	207950000	208400000	0.016496340200000015	0.7480365102950541	450000
chr2	208400000	208500000	0.22786660260000002	0.014222033538526852	100000
chr2	208500000	209250000	-0.0757497984	0.19549989386542135	750000
chr2	209250000	209850000	0.0	1.0	600000
chr2	209850000	211100000	0.1085452205224	0.010825727021863723	1250000
chr2	211100000	212600000	-0.27997474826633334	0.0025472298874973467	1500000
chr2	212600000	212800000	0.1022230321	0.11589895988112928	200000
chr2	212800000	213450000	-0.08939993463846152	0.05773721078327319	650000
chr2	213450000	213750000	-0.25781718465	0.0029717682020802376	300000
chr2	213750000	214200000	-0.06659920804444447	0.14519210358734877	450000
chr2	214200000	214650000	-0.2563146585955556	0.004457652303120356	450000
chr2	214650000	214800000	-0.13261429190000001	0.06792613033326257	150000
chr2	214800000	214850000	-0.2084160412	0.017830609212481426	50000
chr2	214850000	215100000	-0.01027774330000003	0.8337932498407982	250000
chr2	215100000	215550000	-0.2805269524555556	0.0016981532583315645	450000
chr2	215550000	215700000	-0.1473078593	0.05306728932286139	150000
chr2	215700000	216150000	-0.4159248806	0.0021226915729144554	450000
chr2	216150000	216550000	0.06895508967499997	0.005518998089577585	400000
chr2	216550000	217350000	-0.08849893970624995	0.018891954998938653	800000
chr2	217350000	217400000	0.44967743930000004	0.0014858841010401188	50000
chr2	217400000	217950000	0.09617290543636367	0.0452133305030779	550000
chr2	217950000	218400000	0.3042145682444445	0.00382084483124602	450000
chr2	218400000	218900000	0.11267717574999998	0.03651029505412864	500000
chr2	218900000	219050000	-0.14190729480000003	0.05667586499681596	150000
chr2	219050000	219650000	0.11606302848333334	0.029929951178093824	600000
chr2	219650000	220150000	-0.08262359657999999	0.05773721078327319	500000
chr2	220150000	220550000	0.024827864250000026	0.48291233283803864	400000
chr2	220550000	222200000	-0.37093403954242427	0.0021226915729144554	1650000
chr2	222200000	222450000	0.07508296628000007	0.020377839099978774	250000
chr2	222450000	222800000	-0.3721172250571428	0.0010613457864572277	350000
chr2	222800000	223500000	-0.09643117451428569	0.010825727021863723	700000
chr2	223500000	223700000	-0.30678540410000005	0.006580343876034812	200000
chr2	223700000	223850000	-0.13488617326666671	0.02441095308851624	150000
chr2	223850000	224300000	-0.5557153712	0.0004245383145828911	450000
chr2	224300000	224550000	0.022905682000000028	0.653152196985778	250000
chr2	224550000	224650000	-0.04152580480000001	0.4379112714922522	100000
chr2	224650000	225150000	0.07803020905000002	0.17469751645085968	500000
chr2	225150000	225650000	-0.03375914951999999	0.51687539800467	500000
chr2	225650000	226000000	0.18999286644285715	0.013160687752069624	350000
chr2	226000000	226500000	-0.11900083735	0.02441095308851624	500000
chr2	226500000	226850000	0.0498999752	0.3485459562725536	350000
chr2	226850000	227200000	-0.01468969040000001	0.7737210783273191	350000
chr2	227200000	227400000	0.04648052229999999	0.3837826363829336	200000
chr2	227400000	227450000	-0.0059976117999999135	0.8936531521969858	50000
chr2	227450000	227650000	0.0551726010000001	0.30630439397155595	200000
chr2	227650000	227850000	0.3583795980000001	0.0031840373593716833	200000
chr2	227850000	228200000	-0.08128317542857141	0.17469751645085968	350000
chr2	228200000	228250000	-0.33555222999999995	0.00382084483124602	50000
chr2	228250000	228450000	-0.18395648529999997	0.02759499044788792	200000
chr2	228450000	229450000	-0.331802268815	0.0029717682020802376	1000000
chr2	229450000	229700000	-0.21233949509999994	0.016769263426024198	250000
chr2	229700000	229900000	-0.35994587809999995	0.0029717682020802376	200000
chr2	229900000	230150000	-0.19262530239999998	0.02334960730205901	250000
chr2	230150000	230600000	-0.3680590017333334	0.0014858841010401188	450000
chr2	230600000	231700000	-0.13134072015000003	0.017830609212481426	1100000
chr2	231700000	231900000	-0.2806316296	0.007853958819783485	200000
chr2	231900000	232350000	-0.04319805427777769	0.2916578221184462	450000
chr2	232350000	232650000	0.03705958070000004	0.4776056039057525	300000
chr2	232650000	233700000	-0.0729073435857143	0.05221821269369561	1050000
chr2	233700000	233950000	0.04432882579999997	0.4096794735724899	250000
chr2	233950000	234150000	-0.2721605359	0.008703035448949268	200000
chr2	234150000	234400000	-0.041979405800000036	0.4343026958182976	250000
chr2	234400000	234450000	-0.21086238449999994	0.016981532583315643	50000
chr2	234450000	234500000	0.05735918990000011	0.2916578221184462	50000
chr2	234500000	234850000	-0.03655890278571427	0.4776056039057525	350000
chr2	234850000	235450000	0.1404663689166666	0.0070048821906177035	600000
chr2	235450000	235800000	-0.06038707269999999	0.2712799830184674	350000
chr2	235800000	237100000	0.1674930990576923	0.014222033538526852	1300000
chr2	237100000	237250000	-0.07812015379999998	0.1867968584164721	150000
chr2	237250000	238400000	0.049925765182608675	0.02441095308851624	1150000
chr2	238400000	238450000	-0.0211215186	0.6909361069836553	50000
chr2	238450000	240900000	0.08103647606734692	0.007853958819783485	2450000
chr2	240900000	241150000	-0.004884932700000011	0.9138187221396731	250000
chr2	241150000	241600000	0.12464375318888885	0.03651029505412864	450000
chr2	241600000	241800000	-0.12769446680000007	0.07259605179367438	200000
chr2	241800000	242400000	0.10735285759166664	0.014222033538526852	600000
chr2	242400000	242900000	-0.01755706838000004	0.6028444067077053	500000
chr2	242900000	243050000	0.03316714229999995	0.5376777754192316	150000
chr20	50000	250000	-0.0770053476	0.21132713440405748	200000
chr20	250000	450000	0.07219251329999998	0.24260355029585798	200000
chr20	450000	500000	0.3839572192	0.0076077768385460695	50000
chr20	500000	1550000	-0.08439011972380953	0.0016906170752324597	1050000
chr20	1600000	1900000	-0.20909090915000003	0.015215553677092139	300000
chr20	1900000	2150000	0.010160427800000038	0.8250211327134404	250000
chr20	2150000	2400000	-0.07283422464000001	0.03803888419273035	250000
chr20	2400000	2450000	0.1871657754	0.030431107354184278	50000
chr20	2450000	2800000	-0.07333842625714283	0.21132713440405748	350000
chr20	2800000	3000000	0.15775401069999995	0.042265426880811495	200000
chr20	3000000	4200000	-0.04808377899583335	0.19019442096365174	1200000
chr20	4200000	4450000	0.10695187170000002	0.09129332206255283	250000
chr20	4450000	5450000	-0.09724598928000001	0.028740490278951817	1000000
chr20	5450000	5500000	0.0582887701	0.3060016906170752	50000
chr20	5500000	5800000	-0.16720142598333332	0.030431107354184278	300000
chr20	5800000	6450000	0.09271904567692307	0.015215553677092139	650000
chr20	6450000	6800000	-0.06974789918571432	0.2265426880811496	350000
chr20	6800000	7600000	0.11841577537500002	0.030431107354184278	800000
chr20	7600000	7650000	-0.07914438499999998	0.19949281487743026	50000
chr20	7650000	7950000	0.05454545460000004	0.3060016906170752	300000
chr20	7950000	8050000	-0.18074866309999998	0.030431107354184278	100000
chr20	8050000	9400000	0.08391760744074074	0.03803888419273035	1350000
chr20	9400000	9850000	-0.03992869875555556	0.42265426880811496	450000
chr20	9850000	9900000	0.2588235294	0.015215553677092139	50000
chr20	9900000	11800000	-0.06540951310789474	0.015215553677092139	1900000
chr20	11800000	12900000	0.09120077785909092	0.009298393913778529	1100000
chr20	12900000	13800000	-0.09203802735	0.0169061707523246	900000
chr20	13800000	13850000	0.19572192510000003	0.028740490278951817	50000
chr20	13850000	14100000	-0.03957219249999999	0.42265426880811496	250000
chr20	14100000	15400000	0.048231180575384607	0.12003381234150465	1300000
chr20	15400000	15700000	0.0	1.0	300000
chr20	15700000	15800000	-0.005347593579999997	0.9273034657650042	100000
chr20	15800000	16600000	0.0661430481169375	0.026204564666103127	800000
chr20	16600000	16800000	-0.0352941177	0.4708368554522401	200000
chr20	16800000	17950000	0.0793768890973913	0.0760777683854607	1150000
chr20	17950000	18400000	-0.018716577600000006	0.7311918850380389	450000
chr20	18400000	18800000	0.09592245992499998	0.015215553677092139	400000
chr20	18800000	19050000	-0.04770053474000001	0.047337278106508875	250000
chr20	19050000	20050000	0.06983957224000004	0.05917159763313609	1000000
chr20	20050000	20400000	-0.037433155100000004	0.4556213017751479	350000
chr20	20400000	20700000	0.010160427799999983	0.8250211327134404	300000
chr20	20700000	21050000	-0.07058823534285714	0.030431107354184278	350000
chr20	21050000	21500000	0.10059417706666668	0.06170752324598478	450000
chr20	21500000	22200000	-0.05817417874285713	0.0076077768385460695	700000
chr20	22200000	22300000	0.0069518716599999975	0.8884192730346576	100000
chr20	22300000	22450000	0.52566844921	0.0016906170752324597	150000
chr20	22450000	22650000	0.22620320850999998	0.023668639053254437	200000
chr20	22650000	23400000	-0.07422459895999999	0.10397295012679628	750000
chr20	23400000	23600000	0.018716577499999998	0.7311918850380389	200000
chr20	23600000	23750000	-0.1459893048	0.047337278106508875	150000
chr20	23750000	24550000	0.08061497325625	0.042265426880811495	800000
chr20	24550000	25150000	-0.027718360108333357	0.08114961961115807	600000
chr20	25150000	25350000	0.027272727299999966	0.6356720202874049	200000
chr20	25350000	25400000	0.2919786096	0.014370245139475908	50000
chr20	25400000	25700000	-0.06007130123333326	0.03803888419273035	300000
chr20	25700000	25750000	0.2171122995	0.023668639053254437	50000
chr20	25800000	26000000	0.08475935827499999	0.023668639053254437	200000
chr20	26050000	26300000	0.040641711199999986	0.42265426880811496	250000
chr20	29500000	29700000	-0.030481283400000003	0.577345731191885	200000
chr20	29800000	30050000	-0.15454545454	0.042265426880811495	250000
chr20	30050000	30100000	0.7331550802	0.0008453085376162299	50000
chr20	30100000	30450000	0.01550802139999996	0.7776838546069316	350000
chr20	30450000	30850000	-0.09578877007499995	0.060016906170752324	400000
chr20	30850000	31100000	0.0033155079800000877	0.8757396449704142	250000
chr20	31100000	31950000	-0.11843346962941176	0.060016906170752324	850000
chr20	31950000	32650000	0.1051184109857143	0.023668639053254437	700000
chr20	32650000	33100000	-0.0529411764555556	0.10397295012679628	450000
chr20	33100000	34000000	0.08214497918333333	0.030431107354184278	900000
chr20	34000000	34200000	-0.08074866307499995	0.12003381234150465	200000
chr20	34200000	34550000	0.02352941180000001	0.6737109044801353	350000
chr20	34550000	34800000	-0.11016042780000002	0.08706677937447169	250000
chr20	34800000	34850000	0.0280748663	0.6306001690617076	50000
chr20	34850000	34900000	-0.12433155080000002	0.06677937447168217	50000
chr20	34950000	35050000	-0.12433155080000002	0.06677937447168217	100000
chr20	35050000	35100000	0.19919786090000002	0.028740490278951817	50000
chr20	35100000	37550000	-0.10934191857142855	0.0169061707523246	2450000
chr20	37550000	37700000	0.09786096249999998	0.12003381234150465	150000
chr20	37700000	37950000	0.1978609626	0.028740490278951817	250000
chr20	37950000	39100000	0.04247849338434782	0.08706677937447169	1150000
chr20	39100000	39600000	0.33133689841200004	0.0076077768385460695	500000
chr20	39600000	40000000	0.13208556150000006	0.060016906170752324	400000
chr20	40000000	40250000	0.14598930480000005	0.047337278106508875	250000
chr20	40250000	41800000	-0.04121097119516129	0.06677937447168217	1550000
chr20	41800000	42050000	0.16791443844999998	0.03803888419273035	250000
chr20	42050000	43100000	-0.06692131399047617	0.06677937447168217	1050000
chr20	43100000	43350000	0.0	1.0	250000
chr20	43350000	43500000	-0.06791443850000001	0.2569737954353339	150000
chr20	43500000	43900000	0.09485294121249997	0.023668639053254437	400000
chr20	43900000	43950000	-0.24652406420000006	0.0169061707523246	50000
chr20	43950000	44600000	0.09868366929999997	0.0507185122569738	650000
chr20	44600000	45050000	-0.05668449199999992	0.3060016906170752	450000
chr20	45050000	45400000	0.010160427799999983	0.8250211327134404	350000
chr20	45400000	45800000	-0.09625668450000002	0.12003381234150465	400000
chr20	45800000	45850000	0.5561497326	0.0016906170752324597	50000
chr20	45850000	46300000	0.16791443849999999	0.03803888419273035	450000
chr20	46300000	46650000	0.10626432392857142	0.042265426880811495	350000
chr20	46650000	46850000	-0.03061497320000002	0.19949281487743026	200000
chr20	46850000	47600000	0.03593582885333331	0.3448858833474218	750000
chr20	47600000	47650000	-0.05454545459999993	0.3060016906170752	50000
chr20	47650000	47950000	0.056327985733333384	0.28148774302620455	300000
chr20	47950000	48150000	-0.1657754011	0.03803888419273035	200000
chr20	48150000	50250000	0.016297428071428567	0.2654268808114962	2100000
chr20	50250000	51550000	-0.04816947758376922	0.10397295012679628	1300000
chr20	51550000	51600000	0.06737967915000001	0.2569737954353339	50000
chr20	51600000	51750000	-0.03262032089	0.5004226542688082	150000
chr20	51750000	52550000	0.03208556150000003	0.45731191885038036	800000
chr20	52550000	53800000	-0.0854759358224	0.08706677937447169	1250000
chr20	53800000	53950000	0.027272727300000008	0.6356720202874049	150000
chr20	53950000	54100000	-0.026203208569999997	0.6534234995773457	150000
chr20	54100000	55100000	0.0629946524185	0.0507185122569738	1000000
chr20	55100000	55150000	-0.14866310159999996	0.047337278106508875	50000
chr20	55150000	55900000	0.17629233509999997	0.015215553677092139	750000
chr20	55900000	56200000	-0.00802139040000005	0.8757396449704142	300000
chr20	56200000	57250000	0.08497580845238091	0.060016906170752324	1050000
chr20	57250000	57300000	-0.18074866310000004	0.030431107354184278	50000
chr20	57300000	57650000	0.11069518719999995	0.042265426880811495	350000
chr20	57650000	57850000	-0.08061497319999998	0.01775147928994083	200000
chr20	57850000	58500000	0.07441382151538463	0.042265426880811495	650000
chr20	58500000	59550000	-0.09314998724476188	0.08706677937447169	1050000
chr20	59550000	59750000	0.029946524020000004	0.5832628909551987	200000
chr20	59750000	60500000	-0.06303030299333334	0.047337278106508875	750000
chr20	60500000	60700000	0.037433155100000004	0.4556213017751479	200000
chr20	60700000	61100000	-0.052941176499999965	0.33727810650887574	400000
chr20	61150000	61200000	-0.052941176499999965	0.33727810650887574	50000
chr20	61300000	61950000	-0.05569724393076923	0.14285714285714285	650000
chr20	62100000	62150000	-0.19438502680000003	0.028740490278951817	50000
chr20	62200000	62900000	0.026489686728571382	0.42265426880811496	700000
chr21	9400000	9600000	-0.046215573600000004	0.5777460770328102	200000
chr21	9650000	9700000	-0.046215573600000004	0.5777460770328102	50000
chr21	9800000	10050000	-0.08294036064000002	0.21255349500713266	250000
chr21	10350000	10650000	0.1138795323166667	0.16547788873038516	300000
chr21	10700000	10800000	-0.05007925499999999	0.5420827389443652	100000
chr21	10850000	11200000	-0.05513176145142857	0.48502139800285304	350000
chr21	14300000	14600000	0.1797767650666667	0.014265335235378032	300000
chr21	14600000	15150000	-0.02149791953636365	0.7532097004279601	550000
chr21	15150000	15350000	0.001287893799999995	1.0	200000
chr21	15350000	15850000	-0.06257182484000001	0.28815977175463625	500000
chr21	15850000	16250000	0.0187239944	0.8445078459343794	400000
chr21	16250000	17000000	-0.12441714547333331	0.012838801711840228	750000
chr21	17000000	19300000	0.13148577290434776	0.012838801711840228	2300000
chr21	19300000	20850000	-0.10635510076258062	0.012838801711840228	1550000
chr21	20850000	23350000	0.0625678620914	0.14265335235378032	2500000
chr21	23350000	23400000	0.0	1.0	50000
chr21	23400000	26250000	-0.045794096891719295	0.09272467902995721	2850000
chr21	26250000	26700000	0.13344561123999998	0.12981455064194009	450000
chr21	26700000	26800000	-0.193085001	0.012838801711840228	100000
chr21	26800000	27100000	0.1939270854	0.012838801711840228	300000
chr21	27100000	27250000	-0.08896374080000002	0.28815977175463625	150000
chr21	27250000	27300000	-0.3440657816	0.008559201141226819	50000
chr21	27300000	27800000	-0.15192193380000002	0.012838801711840228	500000
chr21	27800000	28900000	-0.32354504025909087	0.007132667617689016	1100000
chr21	28900000	29050000	-0.08519912819999997	0.29529243937232524	150000
chr21	29050000	29100000	0.057658014599999974	0.4793152639087018	50000
chr21	29100000	30300000	-0.26964038048750005	0.007132667617689016	1200000
chr21	30300000	33150000	0.09546230347561403	0.0014265335235378032	2850000
chr21	33150000	33650000	-0.0038636813999999853	0.9743223965763196	500000
chr21	33650000	34150000	0.0783237567	0.012838801711840228	500000
chr21	34150000	34200000	-0.12155736090000002	0.16547788873038516	50000
chr21	34200000	34350000	0.062116108500000045	0.463623395149786	150000
chr21	34350000	34550000	-0.2133940955	0.012838801711840228	200000
chr21	34550000	37850000	0.10213087883030302	0.0014265335235378032	3300000
chr21	37850000	39750000	-0.06819840863947364	0.09272467902995721	1900000
chr21	39750000	40000000	0.05042599560000005	0.5420827389443652	250000
chr21	40000000	40100000	0.27372696650000006	0.012838801711840228	100000
chr21	40100000	40200000	-0.0017832375999999872	1.0	100000
chr21	40200000	41100000	0.05211016443333332	0.29529243937232524	900000
chr21	41100000	42450000	-0.04682282837407406	0.2296718972895863	1350000
chr21	42450000	44250000	0.0848826585833333	0.16547788873038516	1800000
chr21	44250000	45550000	-0.07425965160000003	0.20399429386590584	1300000
chr21	45550000	46200000	0.022115194099999992	0.4978601997146933	650000
chr21	46200000	46700000	-0.04785020800000006	0.557774607703281	500000
chr21	46700000	47000000	0.07360808400000007	0.34522111269614836	300000
chr21	47000000	47050000	-0.21765405189999998	0.012838801711840228	50000
chr21	47050000	48100000	0.13596007059523807	0.014265335235378032	1050000
chr22	16050000	16150000	0.0700416089	0.2773722627737226	100000
chr22	16200000	16250000	0.0700416089	0.2773722627737226	50000
chr22	16300000	16400000	0.05547850209999999	0.3518248175182482	100000
chr22	16450000	16500000	0.3003764612	0.013138686131386862	50000
chr22	16550000	16600000	0.3003764612	0.013138686131386862	50000
chr22	16600000	16650000	-0.0005944125999999966	0.9795620437956204	50000
chr22	16800000	18050000	-0.025492371754	0.2321167883211679	1250000
chr22	18050000	18600000	0.20348722009999998	0.03795620437956204	550000
chr22	18600000	18850000	-0.07911630665999998	0.1591240875912409	250000
chr22	18850000	19400000	0.04913810190000001	0.3883211678832117	550000
chr22	19400000	19700000	-0.0934878806	0.05547445255474453	300000
chr22	19700000	19950000	0.08727957200000003	0.21751824817518248	250000
chr22	19950000	20350000	-0.10405315042500005	0.040875912408759124	400000
chr22	20650000	20750000	-0.15766792160000004	0.040875912408759124	100000
chr22	20750000	21100000	0.14362138752857145	0.032116788321167884	350000
chr22	21100000	21500000	-0.1265107984999999	0.07445255474452554	400000
chr22	21500000	21650000	0.07628294029999999	0.24525547445255474	150000
chr22	21650000	21700000	-0.25534971269999995	0.014598540145985401	50000
chr22	21750000	21850000	0.02134931650000005	0.6072992700729927	100000
chr22	21900000	22350000	0.013258701611111126	0.6072992700729927	450000
chr22	22350000	22800000	-0.06474693442444442	0.042335766423357665	450000
chr22	22800000	23150000	0.09371904100714283	0.05547445255474453	350000
chr22	23150000	23450000	-0.029819694900000027	0.5416058394160584	300000
chr22	23450000	24100000	0.14300193568461544	0.00291970802919708	650000
chr22	24100000	24300000	-0.0030711313000000295	0.910948905109489	200000
chr22	24300000	24650000	0.2405813920285714	0.00291970802919708	350000
chr22	24650000	25350000	-0.04756715445714283	0.03795620437956204	700000
chr22	25350000	25550000	0.2224093521	0.029197080291970802	200000
chr22	25550000	25600000	-0.18535763819999998	0.03795620437956204	50000
chr22	25600000	26750000	0.08872252996521739	0.03795620437956204	1150000
chr22	26750000	26800000	-0.43154349121999996	0.00291970802919708	50000
chr22	26800000	27050000	0.16068951850000007	0.040875912408759124	250000
chr22	27050000	28250000	-0.2633825374916667	0.00291970802919708	1200000
chr22	28250000	28400000	0.093719041	0.17518248175182483	150000
chr22	28400000	29050000	-0.14899940560000008	0.042335766423357665	650000
chr22	29050000	29450000	0.08732910636249999	0.03795620437956204	400000
chr22	29450000	29950000	-0.07420249653999995	0.03795620437956204	500000
chr22	29950000	30250000	0.0525064395	0.3518248175182482	300000
chr22	30250000	30850000	-0.06015124497500001	0.042335766423357665	600000
chr22	30850000	31150000	0.03705171390000006	0.472992700729927	300000
chr22	31150000	31750000	-0.053612707225	0.2321167883211679	600000
chr22	31750000	32350000	0.10060431939999993	0.07445255474452554	600000
chr22	32350000	32900000	-0.039033089	0.43795620437956206	550000
chr22	32900000	33250000	0.05898836652857142	0.059854014598540145	350000
chr22	33250000	33450000	-0.017634238100000005	0.6408759124087591	200000
chr22	33450000	33500000	0.12522290473	0.07445255474452554	50000
chr22	33500000	33950000	-0.00099068754	0.9795620437956204	450000
chr22	33950000	34350000	0.019702298395	0.5547445255474452	400000
chr22	34350000	35000000	-0.0004953437660000001	0.9854014598540146	650000
chr22	35000000	35250000	0.018922131959999998	0.6408759124087591	250000
chr22	35250000	35400000	-0.0014860313100000001	0.962043795620438	150000
chr22	35400000	35650000	0.04705765801	0.3927007299270073	250000
chr22	35650000	35700000	0.6781256191999999	0.00145985401459854	50000
chr22	35700000	36000000	-0.025956013500000097	0.5547445255474452	300000
chr22	36000000	36550000	0.08429850317272725	0.040875912408759124	550000
chr22	36550000	36900000	-0.048444620528571423	0.24525547445255474	350000
chr22	36900000	36950000	0.47285516149999995	0.00291970802919708	50000
chr22	36950000	37900000	-0.09476708414210523	0.07445255474452554	950000
chr22	37900000	39200000	0.012753196880769199	0.17518248175182483	1300000
chr22	39200000	39950000	-0.2023908592733334	0.013138686131386862	750000
chr22	39950000	40100000	0.2893798296	0.013138686131386862	150000
chr22	40100000	40150000	-0.08926094709999999	0.21751824817518248	50000
chr22	40150000	40300000	0.04339211409999999	0.41751824817518246	150000
chr22	40300000	40350000	-0.21170992669999994	0.032116788321167884	50000
chr22	40350000	40750000	0.031008519900000087	0.5416058394160584	400000
chr22	40750000	42050000	-0.06241712518076922	0.013138686131386862	1300000
chr22	42050000	42100000	0.0923320783999999	0.181021897810219	50000
chr22	42100000	42300000	-0.1600951060000001	0.040875912408759124	200000
chr22	42300000	42350000	0.12561917969999992	0.07445255474452554	50000
chr22	42350000	42900000	-0.08179476560909094	0.21751824817518248	550000
chr22	42900000	43600000	0.11670299188571429	0.013138686131386862	700000
chr22	43600000	44200000	-0.012218479614166661	0.5795620437956205	600000
chr22	44200000	44450000	0.139984149	0.05693430656934306	250000
chr22	44450000	45050000	-0.070718578725	0.014598540145985401	600000
chr22	45050000	45350000	0.00802456900000001	0.8364963503649635	300000
chr22	45350000	45450000	-0.08381216560000002	0.2321167883211679	100000
chr22	45450000	46000000	0.07757984043636361	0.032116788321167884	550000
chr22	46000000	46050000	-0.3550624133	0.00291970802919708	50000
chr22	46050000	47850000	0.11980989807777778	0.03795620437956204	1800000
chr22	47850000	48800000	-0.06096899669052633	0.07007299270072993	950000
chr22	48800000	48900000	0.07469784029999998	0.27007299270072993	100000
chr22	48900000	49050000	-0.04775113930000002	0.3883211678832117	150000
chr22	49050000	49150000	0.08391123437	0.2321167883211679	100000
chr22	49150000	50150000	-0.04788488211750001	0.07445255474452554	1000000
chr22	50150000	50250000	0.53972657024	0.00145985401459854	100000
chr22	50250000	50450000	0.04993065190000001	0.3883211678832117	200000
chr22	50450000	50600000	-0.17337031900000008	0.03795620437956204	150000
chr22	50600000	51050000	-0.025658807200000022	0.5766423357664233	450000
chr22	51050000	51100000	-0.4140083218	0.00291970802919708	50000
chr22	51100000	51250000	-0.10788587280000006	0.13576642335766423	150000
chr3	50000	200000	0.0415340038	0.4651948051948052	150000
chr3	200000	550000	-0.04653320201	0.42753246753246754	350000
chr3	550000	600000	0.0038023684600000107	0.9454545454545454	50000
chr3	600000	750000	-0.03715326294999999	0.507012987012987	150000
chr3	750000	1200000	0.052229755687777775	0.20233766233766234	450000
chr3	1200000	1750000	-0.056445181143636364	0.14545454545454545	550000
chr3	1750000	2250000	0.0014487940100000006	0.9784415584415584	500000
chr3	2250000	3100000	-0.046652110225882344	0.22337662337662337	850000
chr3	3100000	3950000	0.08651735661058824	0.0735064935064935	850000
chr3	4000000	4200000	0.08213173145	0.13610389610389612	200000
chr3	4250000	5750000	0.10346947033899999	0.00935064935064935	1500000
chr3	5750000	5850000	-0.04730627389	0.42207792207792205	100000
chr3	5850000	6800000	0.04311450626	0.20233766233766234	950000
chr3	6800000	7450000	-0.042628638285384615	0.37922077922077924	650000
chr3	7450000	9350000	0.13024618948265787	0.0033766233766233766	1900000
chr3	9350000	9400000	-0.40729436290000004	0.004155844155844156	50000
chr3	9400000	9550000	-0.007965503800000051	0.8776623376623377	150000
chr3	9550000	9700000	0.11629864629999997	0.12311688311688311	150000
chr3	9700000	10350000	-0.05400711134615382	0.1277922077922078	650000
chr3	10350000	10600000	0.007621916299999976	0.8838961038961038	250000
chr3	10600000	10700000	0.22946491970000005	0.016883116883116882	100000
chr3	10700000	10800000	-0.032280046699999954	0.5945454545454546	100000
chr3	10800000	11350000	0.04637546415454548	0.4202597402597403	550000
chr3	11350000	11500000	-0.13251025039999997	0.09376623376623376	150000
chr3	11500000	12500000	0.06916846095	0.1161038961038961	1000000
chr3	12500000	12900000	-0.085856076875	0.00935064935064935	400000
chr3	12950000	13100000	-0.019507180900000032	0.7444155844155844	150000
chr3	13100000	13500000	0.20051767180000002	0.022337662337662337	400000
chr3	13500000	13700000	-0.030544929799999954	0.6184415584415585	200000
chr3	13750000	14600000	0.21315630269411764	0.00909090909090909	850000
chr3	14600000	14700000	-0.17641500790000003	0.03532467532467533	100000
chr3	14700000	16050000	0.10978829914814812	0.003116883116883117	1350000
chr3	16050000	16600000	-0.0245425600909091	0.6225974025974026	550000
chr3	16600000	17800000	0.05985652358333334	0.03064935064935065	1200000
chr3	17800000	17900000	-0.05930893100000001	0.3314285714285714	100000
chr3	17900000	18050000	0.16594704170000002	0.04415584415584416	150000
chr3	18050000	18200000	0.07523421219999993	0.2509090909090909	150000
chr3	18200000	19050000	0.23386721892235296	0.0033766233766233766	850000
chr3	19050000	19900000	0.02463050868294118	0.14207792207792208	850000
chr3	19900000	20250000	0.1323613625	0.09402597402597403	350000
chr3	20250000	21300000	-0.038567152804761896	0.00961038961038961	1050000
chr3	21300000	21650000	0.38085530380000004	0.0049350649350649355	350000
chr3	21650000	21800000	0.013961105899999993	0.7935064935064935	150000
chr3	21800000	21950000	0.37573584990000003	0.0049350649350649355	150000
chr3	21950000	22200000	-0.22325743870000006	0.017402597402597402	250000
chr3	22200000	22500000	-0.21089401480000003	0.01922077922077922	300000
chr3	22500000	23200000	-0.38812831516428575	0.0033766233766233766	700000
chr3	23200000	24050000	-0.06380453778823529	0.12311688311688311	850000
chr3	24050000	24750000	0.1330518097142858	0.01818181818181818	700000
chr3	24750000	25650000	-0.1204006994	0.08883116883116883	900000
chr3	25650000	26400000	0.07030602194600004	0.0916883116883117	750000
chr3	26400000	27100000	-0.011120782463499993	0.4825974025974026	700000
chr3	27100000	27750000	0.02314414286923079	0.5311688311688312	650000
chr3	27750000	28250000	-0.36787342237000004	0.001038961038961039	500000
chr3	28250000	28850000	-0.05050402380833333	0.05480519480519481	600000
chr3	28850000	29400000	0.1156083477545455	0.0049350649350649355	550000
chr3	29400000	29500000	-0.01631468030000005	0.7805194805194805	100000
chr3	29500000	30050000	0.0888668276090909	0.05584415584415584	550000
chr3	30050000	30800000	-0.09596246490666668	0.006493506493506494	750000
chr3	30800000	31200000	0.1004306297	0.11948051948051948	400000
chr3	31200000	31550000	-0.20697302672857143	0.02077922077922078	350000
chr3	31550000	31650000	0.2201479717	0.0187012987012987	100000
chr3	31650000	32200000	-0.10739140026363633	0.01818181818181818	550000
chr3	32200000	32600000	0.0502453787875	0.01922077922077922	400000
chr3	32600000	33050000	-0.19473967517777782	0.012727272727272728	450000
chr3	33050000	33200000	0.06911262799999995	0.27974025974025973	150000
chr3	33200000	34100000	-0.06771537212222224	0.03766233766233766	900000
chr3	34100000	34500000	0.03319556428750001	0.4085714285714286	400000
chr3	34500000	35200000	-0.11480322247857144	0.03064935064935065	700000
chr3	35200000	35800000	0.04028659016666666	0.298961038961039	600000
chr3	35800000	37000000	-0.1787358938541667	0.012727272727272728	1200000
chr3	37000000	37350000	0.05466477309999995	0.37272727272727274	350000
chr3	37350000	37400000	0.7116613600999999	0.0005194805194805195	50000
chr3	37400000	37850000	0.15797008489999997	0.05584415584415584	450000
chr3	37850000	38300000	0.045050049300000006	0.4387012987012987	450000
chr3	38300000	38700000	-0.019890853712499976	0.11324675324675325	400000
chr3	38700000	40200000	0.2027975658866667	0.00935064935064935	1500000
chr3	40200000	40250000	0.45836291999999995	0.003116883116883117	50000
chr3	40250000	40500000	0.14796023540000003	0.07090909090909091	250000
chr3	40500000	40750000	0.37567285886000007	0.002857142857142857	250000
chr3	40750000	41150000	0.7205974986999999	0.00025974025974025974	400000
chr3	41150000	41400000	0.38575715239999997	0.0049350649350649355	250000
chr3	41400000	41450000	0.5342213162	0.0018181818181818182	50000
chr3	41450000	41650000	0.26744279270000004	0.011948051948051949	200000
chr3	41650000	41950000	0.36091195759999994	0.0033766233766233766	300000
chr3	41950000	42600000	0.18759437644615382	0.011168831168831168	650000
chr3	42600000	42850000	-0.003664933399999959	0.9467532467532468	250000
chr3	42850000	42900000	0.4997480359	0.0023376623376623377	50000
chr3	42900000	43100000	0.0769292439	0.23064935064935066	200000
chr3	43100000	43150000	0.23296951240000002	0.016883116883116882	50000
chr3	43150000	44200000	-0.07746044109523806	0.016103896103896103	1050000
chr3	44200000	44850000	0.08260548571538463	0.15038961038961038	650000
chr3	44850000	45000000	-0.1299772468666667	0.02909090909090909	150000
chr3	45000000	45250000	0.05856678196	0.016883116883116882	250000
chr3	45250000	45550000	-0.03261790780000007	0.5901298701298702	300000
chr3	45550000	45750000	0.01291889040000005	0.8109090909090909	200000
chr3	45750000	46100000	-0.01242641500000008	0.8187012987012987	350000
chr3	46100000	46250000	0.00935703319999992	0.8584415584415584	150000
chr3	46250000	46900000	-0.09762686746923076	0.012727272727272728	650000
chr3	46900000	47000000	0.008480885100000002	0.874025974025974	100000
chr3	47050000	47450000	0.008480885100000002	0.874025974025974	400000
chr3	47450000	47700000	-0.1836761573000001	0.03168831168831169	250000
chr3	47700000	47850000	0.02437753399999998	0.675064935064935	150000
chr3	47900000	48150000	0.03973589580000003	0.4807792207792208	250000
chr3	48150000	48200000	-0.3092573928	0.00935064935064935	50000
chr3	48200000	48350000	-0.0775037985666666	0.0987012987012987	150000
chr3	48350000	48450000	0.09554023410000001	0.17454545454545456	100000
chr3	48700000	49000000	-0.02357869299999993	0.6875324675324676	300000
chr3	49200000	49700000	-0.07240133317000005	0.06909090909090909	500000
chr3	49800000	49900000	-0.14902822000000004	0.06909090909090909	100000
chr3	49950000	50150000	-0.018155736800000044	0.7612987012987013	200000
chr3	50250000	50350000	-0.018155736800000044	0.7612987012987013	100000
chr3	50350000	50400000	0.1806497239999999	0.03194805194805195	50000
chr3	50450000	50700000	-0.1658267861	0.04701298701298701	250000
chr3	50700000	51350000	0.10352864370000002	0.1457142857142857	650000
chr3	51350000	51950000	0.08309473090000001	0.15038961038961038	600000
chr3	51950000	52000000	0.6556909545	0.0007792207792207792	50000
chr3	52000000	52250000	0.041356483499999985	0.4675324675324675	250000
chr3	52250000	53350000	-0.09507795271818176	0.0916883116883117	1100000
chr3	53350000	53400000	0.5399878599000001	0.0018181818181818182	50000
chr3	53400000	53700000	0.060122088100000026	0.3262337662337662	300000
chr3	53700000	53750000	-0.1600144307	0.05506493506493507	50000
chr3	53750000	54850000	0.10272954246618181	0.1161038961038961	1100000
chr3	54850000	55550000	-0.10178166483571424	0.11948051948051948	700000
chr3	55550000	56400000	0.09978522412117646	0.0374025974025974	850000
chr3	56400000	56600000	-0.024486336599999964	0.6735064935064935	200000
chr3	56600000	56650000	0.7389364822000001	0.00025974025974025974	50000
chr3	56650000	57100000	0.029038871200000038	0.6353246753246753	450000
chr3	57100000	57350000	0.12767368352000008	0.03194805194805195	250000
chr3	57350000	58600000	-0.07216437229599998	0.006493506493506494	1250000
chr3	58600000	58650000	0.519544403	0.002077922077922078	50000
chr3	58650000	58800000	-0.14824083189999998	0.06909090909090909	150000
chr3	58800000	58850000	0.11014842979999995	0.13636363636363635	50000
chr3	58850000	59050000	-0.0383157340000001	0.4922077922077922	200000
chr3	59050000	59400000	-0.2599100455428572	0.0049350649350649355	350000
chr3	59400000	59550000	-0.1482121997	0.07090909090909091	150000
chr3	59550000	60150000	0.05045200847500001	0.20857142857142857	600000
chr3	60150000	60850000	-0.03062264601928571	0.4807792207792208	700000
chr3	60850000	62650000	0.1279632832061111	0.00961038961038961	1800000
chr3	62650000	62700000	-0.008727122799999987	0.8688311688311688	50000
chr3	62700000	63550000	0.1411740452764706	0.02909090909090909	850000
chr3	63550000	63600000	-0.015581693699999982	0.7818181818181819	50000
chr3	63600000	63800000	0.09683441370000001	0.16597402597402597	200000
chr3	63800000	63850000	0.6807270312	0.0007792207792207792	50000
chr3	63850000	64450000	0.07794950794999998	0.1444155844155844	600000
chr3	64450000	64500000	0.8432038391	0.00025974025974025974	50000
chr3	64500000	65300000	0.12947594317125	0.06909090909090909	800000
chr3	65300000	65750000	0.21999335729999997	0.0187012987012987	450000
chr3	65750000	65800000	0.5673087936000001	0.0018181818181818182	50000
chr3	65800000	66100000	0.12532927140000005	0.11194805194805195	300000
chr3	66100000	66150000	-0.21779153399999995	0.0187012987012987	50000
chr3	66250000	67400000	0.08132878236086957	0.09506493506493506	1150000
chr3	67400000	67450000	-0.09402272260000002	0.17844155844155843	50000
chr3	67450000	68150000	0.1401051704857143	0.013246753246753246	700000
chr3	68150000	68200000	-0.04314886502	0.454025974025974	50000
chr3	68200000	69350000	0.07242476180304344	0.12181818181818181	1150000
chr3	69350000	69400000	-0.22878347109999997	0.016883116883116882	50000
chr3	69400000	69500000	0.303639737	0.00935064935064935	100000
chr3	69500000	70000000	0.03435531528000001	0.22415584415584416	500000
chr3	70000000	70550000	0.22932175821909093	0.011168831168831168	550000
chr3	70550000	70800000	0.04595482970000003	0.43272727272727274	250000
chr3	70800000	71000000	0.2875655679	0.00961038961038961	200000
chr3	71000000	71050000	0.6667601988	0.0007792207792207792	50000
chr3	71050000	71250000	0.04730627389999997	0.42207792207792205	200000
chr3	71250000	71450000	-0.07685479989999999	0.23064935064935066	200000
chr3	71450000	71950000	0.1069450489	0.08727272727272728	500000
chr3	71950000	72100000	-0.027109054700000024	0.6522077922077922	150000
chr3	72100000	72200000	-0.4281329455	0.0033766233766233766	100000
chr3	72200000	72800000	0.0026308305250000255	0.9394805194805195	600000
chr3	72800000	72850000	-0.05878209680000002	0.3327272727272727	50000
chr3	72850000	73550000	0.0675623938	0.1457142857142857	700000
chr3	73550000	73900000	-0.13885189412	0.0574025974025974	350000
chr3	73900000	74700000	0.02323224225875	0.4161038961038961	800000
chr3	74700000	75300000	-0.024263004779999996	0.6766233766233766	600000
chr3	75300000	75550000	0.1052666239	0.1444155844155844	250000
chr3	75600000	76650000	0.015249695405714293	0.1444155844155844	1050000
chr3	76650000	77900000	-0.05879148819720001	0.13636363636363635	1250000
chr3	77900000	78650000	0.04960716494833333	0.19714285714285715	750000
chr3	78650000	78700000	-0.47765535885	0.003116883116883117	50000
chr3	78700000	79050000	0.24885470830000006	0.012987012987012988	350000
chr3	79050000	79450000	-0.11811536519999999	0.019740259740259742	400000
chr3	79450000	80050000	-0.3707127913416666	0.002077922077922078	600000
chr3	80050000	80800000	-0.14523329587999997	0.022337662337662337	750000
chr3	80800000	80850000	-0.30689236545000004	0.00935064935064935	50000
chr3	80850000	81200000	-0.15672171704999996	0.0574025974025974	350000
chr3	81200000	81550000	-0.2778363149	0.01090909090909091	350000
chr3	81550000	81850000	0.03430721300000006	0.5514285714285714	300000
chr3	81850000	83900000	-0.09067819148195122	0.04701298701298701	2050000
chr3	83900000	84250000	0.06945048910000007	0.2794805194805195	350000
chr3	84250000	84500000	-0.07995854039999999	0.22441558441558443	250000
chr3	84500000	84950000	0.007072176280000009	0.8867532467532467	450000
chr3	84950000	85100000	-0.0031667315699999976	0.9537662337662338	150000
chr3	85100000	85300000	0.03206816773	0.6	200000
chr3	85300000	86050000	-0.07481427184066665	0.11194805194805195	750000
chr3	86050000	86800000	0.03844209787800001	0.18051948051948052	750000
chr3	86800000	87600000	-0.10514064183125002	0.00961038961038961	800000
chr3	87600000	88050000	0.02706324298	0.6522077922077922	450000
chr3	88050000	89150000	-0.07066085414318184	0.013246753246753246	1100000
chr3	89150000	89300000	0.05897106991999998	0.33194805194805194	150000
chr3	89300000	90350000	-0.06767228732380952	0.16545454545454547	1050000
chr3	93500000	95250000	-0.13920873432657144	0.008571428571428572	1750000
chr3	95250000	95400000	0.000979224400000006	0.9864935064935065	150000
chr3	95400000	97450000	-0.10180023097336585	0.05480519480519481	2050000
chr3	97450000	97700000	0.06438829970000004	0.3080519480519481	250000
chr3	97700000	98200000	-0.0183361202	0.7602597402597403	500000
chr3	98200000	98250000	0.4783081751	0.003116883116883117	50000
chr3	98250000	99200000	-0.11861484804210526	0.048051948051948054	950000
chr3	99200000	100100000	0.07754929208333333	0.0212987012987013	900000
chr3	100100000	101200000	-0.19514260962272728	0.015844155844155845	1100000
chr3	101200000	101250000	0.1214524589	0.11948051948051948	50000
chr3	101250000	101400000	-0.112335937	0.13636363636363635	150000
chr3	101400000	101450000	-0.26762603939999996	0.011948051948051949	50000
chr3	101450000	101950000	-0.08031644404999994	0.15038961038961038	500000
chr3	101950000	102250000	-0.250612731	0.012727272727272728	300000
chr3	102250000	102300000	-0.0014659734000000424	0.9776623376623377	50000
chr3	102300000	103450000	-0.38122553183995656	0.003116883116883117	1150000
chr3	103450000	103650000	-0.2253819548	0.017142857142857144	200000
chr3	103650000	104050000	-0.3120039455125	0.0049350649350649355	400000
chr3	104050000	105050000	-0.12906807611499999	0.02909090909090909	1000000
chr3	105050000	105300000	0.0350207298	0.09506493506493506	250000
chr3	105300000	105350000	-0.19740247840000003	0.024675324675324677	50000
chr3	105350000	105750000	0.04756396460000001	0.42077922077922075	400000
chr3	105750000	106800000	-0.07464329610952378	0.12077922077922078	1050000
chr3	106800000	106900000	0.1343427171	0.08935064935064935	100000
chr3	106900000	107250000	-0.020947385300000065	0.7272727272727273	350000
chr3	107250000	107600000	0.13010268357142857	0.08051948051948052	350000
chr3	107600000	107650000	-0.05614792590000006	0.35974025974025975	50000
chr3	107650000	107900000	0.05123462439999993	0.3927272727272727	250000
chr3	107900000	107950000	-0.004134503100000075	0.9431168831168831	50000
chr3	107950000	108300000	0.14091669149999997	0.08285714285714285	350000
chr3	108300000	108350000	0.5999610600999999	0.0012987012987012987	50000
chr3	108350000	108550000	0.16371944940000002	0.051688311688311686	200000
chr3	108550000	108800000	0.32982683189999995	0.008571428571428572	250000
chr3	108800000	109100000	0.12163570559999996	0.11792207792207793	300000
chr3	109100000	110000000	-0.12287198436666665	0.017142857142857144	900000
chr3	110000000	111050000	0.025156332323809545	0.19116883116883118	1050000
chr3	111050000	111400000	-0.2581037568571428	0.006753246753246753	350000
chr3	111400000	111850000	-0.03818975190000007	0.4961038961038961	450000
chr3	111850000	112250000	-0.28570446889999995	0.009870129870129871	400000
chr3	112250000	113000000	-0.06635476557999996	0.11324675324675325	750000
chr3	113000000	113050000	0.2422864603	0.015844155844155845	50000
chr3	113050000	113600000	-0.03672429918181817	0.3576623376623377	550000
chr3	113600000	113900000	-0.17990814759999996	0.03194805194805195	300000
chr3	113900000	114050000	-0.4013846577	0.004675324675324675	150000
chr3	114050000	114400000	0.030126898328571534	0.13636363636363635	350000
chr3	114400000	115550000	-0.08917589794347826	0.015844155844155845	1150000
chr3	115550000	115850000	0.1643951714	0.051688311688311686	300000
chr3	115850000	116050000	0.466442953	0.003116883116883117	200000
chr3	116050000	116600000	0.08984136668363636	0.1794805194805195	550000
chr3	116600000	116800000	-0.03325354468	0.5771428571428572	200000
chr3	116800000	117350000	0.02986764592527273	0.42493506493506494	550000
chr3	117350000	117500000	-0.007140893780000001	0.8867532467532467	150000
chr3	117500000	118150000	0.11070037229461538	0.039480519480519484	650000
chr3	118150000	118600000	0.3785074557988889	0.004675324675324675	450000
chr3	118600000	118850000	0.09255674916000001	0.1846753246753247	250000
chr3	118850000	118900000	-0.2538596331	0.012727272727272728	50000
chr3	118900000	119450000	0.029389746909090877	0.2522077922077922	550000
chr3	119450000	119550000	-0.09063265910000001	0.19090909090909092	100000
chr3	119550000	119600000	-0.31076917789999997	0.00935064935064935	50000
chr3	119600000	119900000	0.05164692950000005	0.3901298701298701	300000
chr3	119900000	120050000	-0.015575967199999985	0.7818181818181819	150000
chr3	120050000	120300000	0.08089538898	0.03766233766233766	250000
chr3	120300000	120550000	-0.13101564470000004	0.09714285714285714	250000
chr3	120550000	120600000	0.26830176139999995	0.011688311688311689	50000
chr3	120600000	121100000	-0.04210092314000001	0.4631168831168831	500000
chr3	121100000	121350000	0.078853334	0.22545454545454546	250000
chr3	121350000	121400000	-0.052545983399999996	0.3875324675324675	50000
chr3	121400000	122650000	0.10151842774400001	0.01896103896103896	1250000
chr3	122650000	123300000	-0.010737109753846213	0.782077922077922	650000
chr3	123300000	123700000	0.03424422199999999	0.5514285714285714	400000
chr3	123700000	124450000	-0.10782921409999993	0.13974025974025975	750000
chr3	124450000	124900000	0.047452616811111126	0.31246753246753245	450000
chr3	124900000	125300000	-0.10880271207500007	0.06337662337662338	400000
chr3	125300000	125350000	0.38316879309999996	0.0049350649350649355	50000
chr3	125350000	125400000	0.061021142100000036	0.3236363636363636	50000
chr3	125500000	125600000	0.058461415100000025	0.3236363636363636	100000
chr3	125700000	125850000	0.05590168810000001	0.36623376623376624	150000
chr3	125850000	125900000	-0.036380191100000014	0.5194805194805194	50000
chr3	125900000	126050000	0.02761298299999998	0.6514285714285715	150000
chr3	126050000	126200000	-0.027289438100000007	0.6522077922077922	150000
chr3	126250000	126400000	-0.027289438100000007	0.6522077922077922	150000
chr3	126400000	126700000	0.21012666930000004	0.01922077922077922	300000
chr3	126800000	126850000	-0.043229035400000004	0.4527272727272727	50000
chr3	126850000	127300000	0.18458666420000003	0.03168831168831169	450000
chr3	127300000	128100000	-0.07140070604374998	0.05974025974025974	800000
chr3	128150000	128350000	-0.11894140679999998	0.12077922077922078	200000
chr3	128350000	128600000	0.02598094230000003	0.6644155844155845	250000
chr3	128600000	128850000	-0.07866436081999995	0.016883116883116882	250000
chr3	128850000	129050000	0.006064319599999979	0.9116883116883117	200000
chr3	129100000	129750000	-0.046296214684615325	0.15298701298701298	650000
chr3	129800000	129850000	-0.01192534979999993	0.8264935064935065	50000
chr3	129900000	130750000	0.08055004990941175	0.19116883116883118	850000
chr3	130750000	131050000	0.18234761889999998	0.03168831168831169	300000
chr3	131050000	131250000	0.10896877929999998	0.13896103896103895	200000
chr3	131250000	131300000	0.2608459125	0.012727272727272728	50000
chr3	131300000	131550000	0.04608081179999998	0.43272727272727274	250000
chr3	131550000	131750000	0.1517855098	0.06337662337662338	200000
chr3	131750000	131950000	0.008440799900000018	0.874025974025974	200000
chr3	131950000	132150000	0.5117965046	0.002077922077922078	200000
chr3	132150000	133200000	0.059654972685714305	0.19194805194805195	1050000
chr3	133200000	133400000	-0.005102274500000004	0.9293506493506494	200000
chr3	133400000	136800000	0.13633459830941175	0.0012987012987012987	3400000
chr3	136800000	136950000	-0.12227706898999997	0.1161038961038961	150000
chr3	136950000	137450000	0.030623954923999996	0.6083116883116884	500000
chr3	137450000	137700000	0.12523764802999998	0.11194805194805195	250000
chr3	137700000	137750000	0.55141214463	0.0018181818181818182	50000
chr3	137750000	138400000	-0.18026495003076926	0.012727272727272728	650000
chr3	138400000	138650000	0.0006986279999999789	0.9890909090909091	250000
chr3	138650000	138900000	-0.0808976797	0.21948051948051947	250000
chr3	138900000	139100000	-0.3508572509	0.0036363636363636364	200000
chr3	139100000	139550000	0.05874328411111112	0.31922077922077924	450000
chr3	139550000	139600000	-0.14471333349999999	0.07584415584415584	50000
chr3	139600000	140600000	0.129931912375	0.0187012987012987	1000000
chr3	140600000	141200000	-0.03601560650000002	0.4101298701298701	600000
chr3	141200000	141600000	-0.2768456376	0.011168831168831168	400000
chr3	141600000	141750000	-0.13589840496666664	0.0212987012987013	150000
chr3	141750000	142050000	-0.2382321277	0.016103896103896103	300000
chr3	142050000	142350000	-0.11543585984999993	0.08415584415584415	300000
chr3	142350000	143000000	-0.2916569022923076	0.0059740259740259745	650000
chr3	143000000	143250000	-0.21397484939999994	0.01896103896103896	250000
chr3	143250000	145000000	-0.3326521029142857	0.0033766233766233766	1750000
chr3	145000000	145750000	-0.1892938131306666	0.022337662337662337	750000
chr3	145750000	145900000	0.016744164699999953	0.7774025974025974	150000
chr3	145900000	146300000	-0.17694184210000002	0.016883116883116882	400000
chr3	146300000	146350000	0.08244382339999995	0.21298701298701297	50000
chr3	146350000	147500000	-0.30033806022173903	0.0049350649350649355	1150000
chr3	147500000	147600000	0.0028689557000000088	0.9592207792207792	100000
chr3	147600000	148600000	-0.19847246718000006	0.012727272727272728	1000000
chr3	148600000	148650000	0.28618549139999994	0.009870129870129871	50000
chr3	148650000	149000000	-0.027807682700000003	0.6477922077922078	350000
chr3	149000000	149700000	0.055285684842857126	0.14545454545454545	700000
chr3	149700000	150600000	-0.06968463758888888	0.11324675324675325	900000
chr3	150600000	150850000	0.10147284520000004	0.15272727272727274	250000
chr3	150850000	150950000	-0.18531965090000002	0.03168831168831169	100000
chr3	150950000	151100000	0.007633369299999915	0.8838961038961038	150000
chr3	151100000	151200000	-0.0077249925000000275	0.8797402597402597	100000
chr3	151200000	151550000	-0.269469959	0.011688311688311689	350000
chr3	151550000	152150000	0.038088584466666665	0.4857142857142857	600000
chr3	152150000	152300000	-0.137589619	0.08883116883116883	150000
chr3	152300000	152750000	-0.4916164647	0.0025974025974025974	450000
chr3	152750000	153000000	-0.03362003800000002	0.5714285714285714	250000
chr3	153000000	153100000	-0.5352978904000001	0.0018181818181818182	100000
chr3	153100000	153500000	-0.27079277100000004	0.011428571428571429	400000
chr3	153500000	153650000	-0.1566988112	0.0574025974025974	150000
chr3	153650000	153800000	-0.29152445963333334	0.00935064935064935	150000
chr3	153800000	155050000	-0.14759076438320004	0.016883116883116882	1250000
chr3	155050000	155450000	-0.313065487785	0.0018181818181818182	400000
chr3	155450000	155700000	-0.10680417799999997	0.14181818181818182	250000
chr3	155700000	156000000	0.011882401499999973	0.8264935064935065	300000
chr3	156000000	156200000	-0.06661589200000001	0.29324675324675326	200000
chr3	156200000	156250000	0.5407666583	0.0018181818181818182	50000
chr3	156250000	156750000	-0.10665299949999993	0.02909090909090909	500000
chr3	156750000	158500000	0.09154627469142855	0.006493506493506494	1750000
chr3	158500000	158750000	-0.14996449590000005	0.06727272727272728	250000
chr3	158750000	159000000	0.06480060479999994	0.30597402597402595	250000
chr3	159000000	159300000	-0.031106122800000024	0.6085714285714285	300000
chr3	159300000	159350000	0.232316696	0.016883116883116882	50000
chr3	159350000	159900000	-0.07836242022727265	0.012207792207792207	550000
chr3	159900000	160250000	0.02093756857142854	0.45454545454545453	350000
chr3	160250000	160400000	-0.19535240630000006	0.025714285714285714	150000
chr3	160400000	160500000	0.09133701350000001	0.18753246753246752	100000
chr3	160500000	167650000	-0.2511856972917483	0.0049350649350649355	7150000
chr3	167650000	167850000	0.10237476237500004	0.1	200000
chr3	167850000	168550000	-0.18007421489999992	0.03194805194805195	700000
chr3	168550000	168900000	0.010831187257142811	0.7477922077922078	350000
chr3	168900000	169200000	-0.14151796969999997	0.08051948051948052	300000
chr3	169200000	169400000	0.06653572159999999	0.29324675324675326	200000
chr3	169400000	169850000	-0.24986574638888884	0.0049350649350649355	450000
chr3	169850000	169900000	0.06565957350000007	0.3015584415584416	50000
chr3	169900000	170800000	-0.14132581511111109	0.00909090909090909	900000
chr3	170800000	172500000	0.09072579829117647	0.008571428571428572	1700000
chr3	172500000	172900000	-0.41667287039999995	0.002857142857142857	400000
chr3	172900000	173000000	-0.18213001360000003	0.03168831168831169	100000
chr3	173000000	173400000	-0.31026238641250004	0.003116883116883117	400000
chr3	173400000	174550000	-0.0798572070478261	0.03194805194805195	1150000
chr3	174550000	175550000	0.09620192640999996	0.00935064935064935	1000000
chr3	175550000	176650000	-0.15238002025454545	0.03766233766233766	1100000
chr3	176650000	176900000	0.1192764047	0.12077922077922078	250000
chr3	176900000	178150000	-0.15041115972800004	0.016883116883116882	1250000
chr3	178150000	178500000	0.3931557368000001	0.004675324675324675	350000
chr3	178500000	178750000	0.1347664751	0.08935064935064935	250000
chr3	178750000	179300000	-0.05886122599999995	0.1457142857142857	550000
chr3	179300000	180150000	0.07610463385882354	0.012727272727272728	850000
chr3	180150000	180300000	-0.02965160229999997	0.6241558441558441	150000
chr3	180300000	181400000	0.16939983588181817	0.00935064935064935	1100000
chr3	181400000	181850000	0.6128933122777779	0.0007792207792207792	450000
chr3	181850000	182450000	0.3759954493166666	0.003116883116883117	600000
chr3	182450000	182700000	0.12141237370000002	0.11948051948051948	250000
chr3	182700000	183850000	-0.11667783739565218	0.015844155844155845	1150000
chr3	183850000	183900000	0.04896694689999992	0.4101298701298701	50000
chr3	183900000	184100000	-0.03123783120000001	0.6083116883116884	200000
chr3	184100000	184300000	0.12568431179999995	0.11194805194805195	200000
chr3	184300000	184550000	-0.002302036300000032	0.9664935064935065	250000
chr3	184550000	184750000	0.013978285199999996	0.7935064935064935	200000
chr3	184750000	184950000	-0.04233570790000002	0.4620779220779221	200000
chr3	184950000	185200000	0.13383878879999994	0.0916883116883117	250000
chr3	185200000	185300000	0.5717582519	0.0018181818181818182	100000
chr3	185300000	185950000	0.10773979323846154	0.08883116883116883	650000
chr3	185950000	186000000	0.4159298623	0.003896103896103896	50000
chr3	186000000	186450000	0.12756831665555557	0.1	450000
chr3	186450000	186500000	0.22826808990000003	0.016883116883116882	50000
chr3	186500000	187100000	0.09260256090000003	0.13896103896103895	600000
chr3	187100000	187150000	0.3170052913	0.00909090909090909	50000
chr3	187150000	187400000	0.023381130200000017	0.6958441558441558	250000
chr3	187400000	187450000	0.5149918685	0.002077922077922078	50000
chr3	187450000	188050000	-0.12942178036666663	0.022337662337662337	600000
chr3	188050000	188700000	0.039479526569230775	0.024675324675324677	650000
chr3	188700000	188950000	-0.2424811599	0.015844155844155845	250000
chr3	188950000	189250000	0.08920104446666671	0.15038961038961038	300000
chr3	189250000	189700000	-0.15653274389999994	0.0574025974025974	450000
chr3	189700000	189900000	0.03215120140000005	0.32051948051948054	200000
chr3	189900000	190200000	-0.018250223399999932	0.7612987012987013	300000
chr3	190200000	190400000	0.000521107700000023	0.9906493506493507	200000
chr3	190400000	190450000	0.27697161960000005	0.01090909090909091	50000
chr3	190450000	190950000	-0.12307533726000001	0.06493506493506493	500000
chr3	190950000	191150000	0.03377178925000002	0.16727272727272727	200000
chr3	191150000	192150000	-0.19994044485799994	0.0015584415584415584	1000000
chr3	192150000	192500000	0.07766304868571429	0.0587012987012987	350000
chr3	192500000	192700000	-0.029897840000000064	0.6231168831168831	200000
chr3	192700000	194400000	0.09556111882941176	0.0033766233766233766	1700000
chr3	194400000	194800000	-0.020377602699999997	0.7319480519480519	400000
chr3	194850000	195000000	-0.020377602699999997	0.7319480519480519	150000
chr3	195000000	195200000	0.0904179169	0.19116883116883118	200000
chr3	195250000	195350000	0.1428508028	0.025714285714285714	100000
chr3	195400000	195500000	-0.0419176765	0.4631168831168831	100000
chr3	195550000	195650000	-0.0419176765	0.4631168831168831	100000
chr3	195750000	195950000	0.04899557919999997	0.4101298701298701	200000
chr3	195950000	196900000	-0.03084571960526315	0.10311688311688312	950000
chr3	196950000	197100000	-0.05304609423333332	0.10311688311688312	150000
chr3	197150000	197200000	-0.015853700500000012	0.7807792207792208	50000
chr3	197250000	197350000	-0.015853700500000012	0.7807792207792208	100000
chr3	197400000	197500000	-0.030534908550000017	0.43636363636363634	100000
chr3	197500000	197700000	0.2610978766	0.008571428571428572	200000
chr3	197700000	197850000	-0.040652129099999934	0.4716883116883117	150000
chr4	50000	650000	0.12219319544999997	0.034176533907427344	600000
chr4	650000	800000	-0.07074989089999995	0.296286329386437	150000
chr4	900000	950000	-0.07074989089999995	0.296286329386437	50000
chr4	1050000	1200000	-0.07074989089999995	0.296286329386437	150000
chr4	1250000	1300000	-0.07074989089999995	0.296286329386437	50000
chr4	1650000	1750000	-0.07817104109999995	0.2607642626480086	100000
chr4	1850000	2750000	-0.17352774441111116	0.016684607104413347	900000
chr4	2750000	2850000	0.061101713399999924	0.35306781485468247	100000
chr4	2850000	3450000	-0.1841105760416667	0.04090419806243272	600000
chr4	3650000	3700000	-0.013718555600000015	0.8196986006458558	50000
chr4	3750000	3850000	-0.013718555600000015	0.8196986006458558	100000
chr4	4000000	4050000	0.09941988159999993	0.2093649085037675	50000
chr4	4150000	5700000	0.18774566277419352	0.002960172228202368	1550000
chr4	5700000	5850000	-0.1318606988666667	0.04386437029063509	150000
chr4	5850000	6250000	0.34832683075	0.002960172228202368	400000
chr4	6250000	6650000	0.09937725092500005	0.1832615715823466	400000
chr4	6650000	7100000	-0.07258888410000006	0.23708288482238968	450000
chr4	7100000	7450000	0.11611235400000008	0.1727664155005382	350000
chr4	7500000	7700000	0.11611235400000008	0.1727664155005382	200000
chr4	7750000	7800000	0.11611235400000008	0.1727664155005382	50000
chr4	7800000	8200000	-0.14811904875000004	0.0193756727664155	400000
chr4	8200000	8650000	0.021101243566666636	0.6811087190527448	450000
chr4	8650000	9100000	0.23136337873333337	0.02691065662002153	450000
chr4	9400000	11200000	0.1406311577611111	0.038751345532831	1800000
chr4	11200000	11700000	-0.11818250032000006	0.048708288482238966	500000
chr4	11700000	11750000	0.1619659227	0.07185145317545748	50000
chr4	11750000	12000000	-0.010575821200000002	0.8606027987082885	250000
chr4	12000000	12450000	0.23329218054444445	0.005651237890204521	450000
chr4	12450000	12750000	0.15361712869999997	0.06996770721205597	300000
chr4	12750000	13150000	0.20887673253999997	0.024219590958019375	400000
chr4	13150000	13300000	0.06744174949999998	0.31216361679224974	150000
chr4	13300000	13600000	0.3420243097666667	0.0024219590958019376	300000
chr4	13600000	14200000	0.066843214525	0.18541442411194833	600000
chr4	14200000	14250000	-0.03471161190000005	0.569967707212056	50000
chr4	14250000	14450000	0.10867074099999996	0.1832615715823466	200000
chr4	14450000	15250000	-0.023457962762500017	0.5740043057050592	800000
chr4	15250000	15700000	0.13365914548888883	0.06297093649085038	450000
chr4	15700000	16000000	-0.06451671576666661	0.01883745963401507	300000
chr4	16000000	16300000	0.2399323365000001	0.02691065662002153	300000
chr4	16300000	17000000	0.16922483274285713	0.05974165769644779	700000
chr4	17000000	17450000	0.27577621960000004	0.01426264800861141	450000
chr4	17450000	17650000	0.19654793729999998	0.055166846071044134	200000
chr4	17650000	18050000	0.3044769043500001	0.00511302475780409	400000
chr4	18050000	18100000	0.02279548179999996	0.7198600645855759	50000
chr4	18100000	18250000	0.24889842299999998	0.019644779332615717	150000
chr4	18250000	19850000	0.12488212617812501	0.05678148546824543	1600000
chr4	19850000	20050000	0.24312111199999997	0.02529601722282024	200000
chr4	20050000	20300000	0.04757380219999996	0.18057050592034446	250000
chr4	20300000	20750000	0.4006113809333334	0.002960172228202368	450000
chr4	20750000	20800000	-0.1495927916	0.08019375672766416	50000
chr4	20800000	21750000	0.07491944147526315	0.22631862217438106	950000
chr4	21750000	21950000	0.25286819269999994	0.019644779332615717	200000
chr4	21950000	22000000	0.1508273764	0.0793864370290635	50000
chr4	22000000	22350000	0.31075384702	0.008073196986006458	350000
chr4	22350000	22400000	0.75416757612	0.00026910656620021526	50000
chr4	22400000	22550000	0.32585875259999997	0.007534983853606028	150000
chr4	22550000	22600000	0.05498676739999997	0.39128094725511303	50000
chr4	22600000	22750000	0.36258480656666664	0.002960172228202368	150000
chr4	22750000	22950000	0.19237354030000003	0.059472551130247575	200000
chr4	22950000	23150000	-0.02685051300000002	0.6622712594187298	200000
chr4	23150000	25400000	0.18454078599955553	0.006996770721205597	2250000
chr4	25400000	25450000	-0.213092055	0.04198062432723358	50000
chr4	25450000	25850000	0.025878533199999998	0.6708826695371367	400000
chr4	25850000	25900000	0.5843200916	0.0016146393972012918	50000
chr4	25900000	26350000	0.06593773869999997	0.3156620021528525	450000
chr4	26350000	26400000	0.19829067990000004	0.05382131324004306	50000
chr4	26400000	26600000	-0.04475199169999999	0.49327233584499464	200000
chr4	26600000	27050000	0.10046859649999995	0.20909580193756727	450000
chr4	27050000	27100000	-0.4505518117	0.002960172228202368	50000
chr4	27100000	27450000	0.10210756376714285	0.17357373519913885	350000
chr4	27450000	27750000	-0.002279320816666671	0.9346071044133477	300000
chr4	27750000	28050000	0.00823965950333333	0.8371905274488698	300000
chr4	28050000	28350000	-0.054635490575	0.25645855758880515	300000
chr4	28350000	28650000	0.0023498035600000022	0.9620559741657696	300000
chr4	28650000	29850000	-0.03296247475875	0.2742195909580194	1200000
chr4	29850000	30050000	0.03598371165	0.5578579117330463	200000
chr4	30050000	30700000	-0.0586191644530769	0.24677072120559743	650000
chr4	30700000	31750000	-0.44997479510142846	0.001883745963401507	1050000
chr4	31750000	32050000	-0.16768525595000003	0.05382131324004306	300000
chr4	32050000	32550000	-0.327610362337	0.005651237890204521	500000
chr4	32550000	32750000	-0.20564362112999998	0.04520990312163617	200000
chr4	32750000	33750000	-0.31870498199599995	0.002152852529601722	1000000
chr4	33750000	34800000	-0.1140906037904762	0.06969860064585576	1050000
chr4	34800000	35200000	-0.286918176325	0.005651237890204521	400000
chr4	35200000	35500000	-0.1485048565	0.08234660925726588	300000
chr4	35500000	35650000	-0.27718132710000004	0.015339074273412271	150000
chr4	35650000	36000000	-0.05204695520000001	0.43030139935414424	350000
chr4	36000000	36050000	-0.34248813170000003	0.006996770721205597	50000
chr4	36050000	36300000	0.054543408199999976	0.40016146393972013	250000
chr4	36300000	38050000	-0.058628256520000005	0.04601722282023681	1750000
chr4	38050000	38200000	0.012015033300000089	0.8350376749192681	150000
chr4	38200000	38650000	0.24791962240000004	0.004036598493003229	450000
chr4	38650000	38850000	0.12050502019999998	0.15769644779332614	200000
chr4	38850000	40350000	-0.057827562813333344	0.16361679224973089	1500000
chr4	40350000	40850000	-0.32721713682	0.002960172228202368	500000
chr4	40850000	40900000	0.1928100786	0.059472551130247575	50000
chr4	40900000	41250000	-0.01307227430000002	0.8272335844994618	350000
chr4	41250000	41900000	-0.3256257922538461	0.004036598493003229	650000
chr4	41900000	42050000	-0.003598030100000038	0.9434876210979548	150000
chr4	42050000	42100000	-0.2930228909	0.01318622174381055	50000
chr4	42100000	42950000	0.1985976208847059	0.01318622174381055	850000
chr4	42950000	43850000	-0.011851141966111114	0.366254036598493	900000
chr4	43850000	44800000	0.059735556891578945	0.06216361679224973	950000
chr4	44800000	46250000	-0.05389836185527586	0.18972012917115177	1450000
chr4	46250000	46850000	0.07963753687416665	0.24677072120559743	600000
chr4	46850000	46950000	-0.49523218369999994	0.0024219590958019376	100000
chr4	46950000	47650000	0.16345141955000006	0.002960172228202368	700000
chr4	47650000	47800000	-0.03634863039999997	0.556243272335845	150000
chr4	47800000	48000000	0.07311333620000005	0.2860602798708288	200000
chr4	48000000	48100000	-0.1787248991	0.06350914962325081	100000
chr4	48100000	49000000	0.14870209443333338	0.04601722282023681	900000
chr4	49000000	49100000	-0.3874959075	0.004036598493003229	100000
chr4	52650000	54800000	0.12266716940465118	0.005382131324004306	2150000
chr4	54800000	55150000	-0.018962130300000046	0.7529601722282023	350000
chr4	55150000	55350000	0.3319634672	0.006996770721205597	200000
chr4	55350000	55800000	0.0882906193111111	0.18702906350914963	450000
chr4	55800000	56200000	-0.17259290079999998	0.02529601722282024	400000
chr4	56200000	56400000	0.1273634453	0.12944025834230355	200000
chr4	56400000	56450000	0.5740546218	0.0016146393972012918	50000
chr4	56450000	56900000	0.09097047907777778	0.16415500538213132	450000
chr4	56900000	56950000	-0.015667630700000046	0.7914424111948332	50000
chr4	56950000	57200000	0.11300883989999999	0.1778794402583423	250000
chr4	57200000	57250000	0.5174615300000001	0.001883745963401507	50000
chr4	57250000	58000000	-0.0684451053933333	0.25053821313240043	750000
chr4	58000000	58050000	0.7679219415	0.00026910656620021526	50000
chr4	58050000	58300000	0.1501111809	0.07992465016146394	250000
chr4	58300000	59700000	0.05144038134592856	0.25672766415500536	1400000
chr4	59700000	59900000	0.11179471786	0.1797631862217438	200000
chr4	59900000	60050000	0.0251759795	0.6811087190527448	150000
chr4	60050000	60100000	0.09502892064	0.21555435952637245	50000
chr4	60100000	62550000	-0.03159661359818368	0.2739504843918192	2450000
chr4	62550000	63500000	0.021604156017894737	0.366254036598493	950000
chr4	63500000	63650000	-0.027317745279999996	0.6517761033369214	150000
chr4	63650000	66150000	0.08943495580638	0.07185145317545748	2500000
chr4	66150000	66200000	-0.10600035470000002	0.19402583423035522	50000
chr4	66200000	66250000	0.34483452470000003	0.006727664155005382	50000
chr4	66250000	66550000	0.10770217180000008	0.18541442411194833	300000
chr4	66550000	66950000	0.34403988869999996	0.005920344456404736	400000
chr4	66950000	67300000	0.18355751390000005	0.06270182992465016	350000
chr4	67300000	67350000	-0.1142366037	0.17653390742734124	50000
chr4	67350000	67550000	0.05273927760000002	0.4208826695371367	200000
chr4	67550000	67650000	-0.0558768962	0.3848223896663079	100000
chr4	67650000	68650000	0.09043708393170002	0.17357373519913885	1000000
chr4	68650000	69850000	-0.27128692387083336	0.0024219590958019376	1200000
chr4	69850000	70050000	0.05015074209999998	0.4472551130247578	200000
chr4	70050000	70750000	-0.30416484771428565	0.007534983853606028	700000
chr4	70750000	71100000	-0.09388154612142859	0.14477933261571582	350000
chr4	71100000	71450000	-0.23255211171	0.029870828848223896	350000
chr4	71450000	71500000	-0.84284622941	0.00026910656620021526	50000
chr4	71500000	72050000	-0.14270460251818182	0.06216361679224973	550000
chr4	72050000	72650000	-0.2842216432	0.002960172228202368	600000
chr4	72650000	73050000	-0.04660770558749999	0.24757804090419805	400000
chr4	73050000	73450000	0.02637645972499998	0.24085037674919269	400000
chr4	73450000	75400000	-0.1416178359461539	0.017222820236813777	1950000
chr4	75400000	75450000	0.05219019420000004	0.42895586652314316	50000
chr4	75500000	75600000	0.05219019420000004	0.42895586652314316	100000
chr4	75600000	75700000	-0.20476713409999991	0.04628632938643703	100000
chr4	75700000	76400000	0.15641321467142857	0.004843918191603875	700000
chr4	76400000	77350000	-0.11319246594210526	0.06781485468245425	950000
chr4	77350000	77400000	0.11160373239999999	0.18057050592034446	50000
chr4	77400000	77650000	-0.04648450289999995	0.4736275565123789	250000
chr4	77650000	78000000	0.025206673499999943	0.6811087190527448	350000
chr4	78000000	78200000	0.23358547959999998	0.02852529601722282	200000
chr4	78200000	78600000	-0.026154780100000052	0.6671151776103337	400000
chr4	78600000	78900000	0.19174942698333333	0.004036598493003229	300000
chr4	78900000	79900000	-0.07264763862500005	0.04386437029063509	1000000
chr4	79900000	80800000	0.31210173458999996	0.002960172228202368	900000
chr4	80800000	82000000	0.08996141069166667	0.08019375672766416	1200000
chr4	82000000	82100000	0.21315685369999998	0.04198062432723358	100000
chr4	82100000	82300000	0.09627373680000001	0.21420882669537136	200000
chr4	82300000	82400000	0.2113015661	0.04198062432723358	100000
chr4	82400000	82450000	0.37306627195	0.004843918191603875	50000
chr4	82450000	83200000	0.20696528609533338	0.04386437029063509	750000
chr4	83200000	83250000	0.79979946526	0.00026910656620021526	50000
chr4	83250000	83600000	-0.010862299399999942	0.8554897739504844	350000
chr4	83600000	84000000	0.1144382469	0.028794402583423036	400000
chr4	84000000	84600000	-0.018965540766666678	0.49327233584499464	600000
chr4	84600000	85900000	0.1410852802538462	0.06216361679224973	1300000
chr4	85900000	85950000	-0.23746316699999992	0.02691065662002153	50000
chr4	85950000	86100000	0.10812506830000002	0.18541442411194833	150000
chr4	86100000	86300000	-0.008758048600000012	0.8767491926803014	200000
chr4	86300000	86600000	0.1852832042	0.06216361679224973	300000
chr4	86600000	86650000	-0.14192267809999992	0.08907427341227125	50000
chr4	86650000	86900000	0.05288251669999999	0.4208826695371367	250000
chr4	86900000	87000000	0.27898545789999996	0.01426264800861141	100000
chr4	87000000	87400000	-0.11248021929999996	0.1797631862217438	400000
chr4	87400000	88100000	0.08868401263571421	0.030947255113024756	700000
chr4	88100000	89100000	-0.11788868959500003	0.01776103336921421	1000000
chr4	89100000	89200000	0.16605164790000004	0.06969860064585576	100000
chr4	89200000	89450000	-0.01593364619999993	0.7914424111948332	250000
chr4	89450000	90050000	0.027437111133333286	0.5923035522066739	600000
chr4	90050000	90600000	-0.33156010335454544	0.002960172228202368	550000
chr4	90600000	90650000	0.13027256359999995	0.12405812701829924	50000
chr4	90650000	93100000	-0.20911741320563262	0.005382131324004306	2450000
chr4	93100000	93250000	0.1950643894	0.05758880516684607	150000
chr4	93250000	93700000	-0.026821334633333343	0.5680839612486545	450000
chr4	93700000	94100000	0.10252851145	0.16415500538213132	400000
chr4	94100000	95100000	-0.23137908569000004	0.01318622174381055	1000000
chr4	95100000	95300000	0.25482920440000006	0.0193756727664155	200000
chr4	95300000	95350000	-0.2690678543999999	0.017222820236813777	50000
chr4	95350000	95500000	-0.02602518279999999	0.6708826695371367	150000
chr4	95500000	95800000	0.08544213140000001	0.24407965554359526	300000
chr4	95800000	96100000	0.31338330789999996	0.002960172228202368	300000
chr4	96100000	99050000	-0.28669193023	0.002960172228202368	2950000
chr4	99050000	99600000	0.06923285844545456	0.008073196986006458	550000
chr4	99600000	99650000	-0.022757966899999982	0.7206673842841765	50000
chr4	99650000	100050000	0.09787622428750001	0.0793864370290635	400000
chr4	100050000	100450000	-0.19132312019999997	0.059472551130247575	400000
chr4	100450000	101350000	-0.5093611308166667	0.0016146393972012918	900000
chr4	101350000	101850000	-0.28940166974	0.007534983853606028	500000
chr4	101850000	102350000	0.04016834009999992	0.5365984930032293	500000
chr4	102350000	102650000	-0.008839899599999979	0.8756727664155005	300000
chr4	102650000	103150000	-0.30865437081999997	0.00511302475780409	500000
chr4	103150000	103250000	-0.09603841530000001	0.21555435952637245	100000
chr4	103250000	103350000	-0.38831782710000007	0.004036598493003229	100000
chr4	103350000	104100000	-0.01040257012000001	0.7454251883745964	750000
chr4	104100000	104150000	0.5061388191	0.002152852529601722	50000
chr4	104150000	105600000	-0.07564495233896551	0.07965554359526372	1450000
chr4	105600000	106050000	-0.47046886941000005	0.0024219590958019376	450000
chr4	106050000	106400000	0.11305999665714293	0.07346609257265878	350000
chr4	106400000	106650000	-0.11706046050000003	0.1671151776103337	250000
chr4	106650000	106750000	0.03367483360000001	0.5888051668460711	100000
chr4	106750000	106950000	-0.13144576009999998	0.12136706135629709	200000
chr4	106950000	108300000	0.13304665299259255	0.00511302475780409	1350000
chr4	108300000	108550000	-0.004058441600000018	0.9383745963401507	250000
chr4	108550000	108900000	0.04180194810000004	0.5228740581270183	350000
chr4	108900000	109750000	-0.28389310269999996	0.002960172228202368	850000
chr4	109750000	109800000	0.04128355880000001	0.5301399354144241	50000
chr4	109800000	110300000	-0.19062738740000001	0.05974165769644779	500000
chr4	110300000	110350000	-0.5840097403	0.0016146393972012918	50000
chr4	110350000	110750000	0.03936688310000003	0.5414424111948332	400000
chr4	110750000	110950000	-0.4448631725	0.002960172228202368	200000
chr4	110950000	111200000	0.01705227549999999	0.7766415500538213	250000
chr4	111200000	111750000	-0.31379101228181816	0.007265877287405812	550000
chr4	111750000	111900000	-0.2406348903	0.02691065662002153	150000
chr4	111900000	113000000	-0.35313836276999994	0.00026910656620021526	1100000
chr4	113000000	113750000	-0.06715163335333334	0.04171151776103337	750000
chr4	113750000	115350000	0.10078683459374997	0.01264800861141012	1600000
chr4	115350000	118400000	-0.13654187458622957	0.05059203444564048	3050000
chr4	118400000	118450000	0.012021854100000007	0.8350376749192681	50000
chr4	118450000	119150000	-0.21816632502500002	0.01883745963401507	700000
chr4	119150000	119200000	0.1641554349	0.06996770721205597	50000
chr4	119200000	119500000	-0.2053298592	0.04601722282023681	300000
chr4	119500000	119600000	0.22324156929999994	0.038751345532831	100000
chr4	119600000	120200000	-0.061186974758333346	0.05758880516684607	600000
chr4	120200000	120400000	0.05041334717500001	0.06216361679224973	200000
chr4	120400000	122550000	-0.12958801381976745	0.005651237890204521	2150000
chr4	122550000	122600000	0.22177848420000001	0.038751345532831	50000
chr4	122600000	123050000	-0.03478323143333336	0.48708288482238965	450000
chr4	123050000	123300000	0.04549206049999999	0.48708288482238965	250000
chr4	123300000	123450000	-0.02245784669999995	0.7209364908503767	150000
chr4	123450000	123650000	0.1926736604	0.059472551130247575	200000
chr4	123650000	124200000	-0.0439855694545455	0.3458019375672766	550000
chr4	124200000	125950000	0.12618050465142852	0.019644779332615717	1750000
chr4	125950000	126200000	-0.08027870240000001	0.25645855758880515	250000
chr4	126200000	126700000	0.044937861510000045	0.18057050592034446	500000
chr4	126700000	127150000	-0.017850700933333317	0.7588805166846071	450000
chr4	127150000	127350000	0.04871835099999999	0.4542518837459634	200000
chr4	127350000	127450000	0.17302261810000003	0.06727664155005382	100000
chr4	127450000	127550000	0.5032638055	0.002152852529601722	100000
chr4	127550000	127800000	0.08782262899999993	0.23869752421959095	250000
chr4	127800000	128000000	0.16870498199999995	0.06916038751345532	200000
chr4	128000000	128250000	-0.10958815340000005	0.18057050592034446	250000
chr4	128250000	128300000	0.03930890539999998	0.5414424111948332	50000
chr4	128300000	128750000	-0.10426708564444444	0.11921420882669537	450000
chr4	128750000	129550000	0.07874122658124998	0.029870828848223896	800000
chr4	129550000	129800000	-0.09480724110000005	0.21555435952637245	250000
chr4	129800000	130050000	0.13125818509999998	0.12136706135629709	250000
chr4	130050000	134000000	-0.15244263699620253	0.04628632938643703	3950000
chr4	134000000	134200000	0.12885466685000002	0.06781485468245425	200000
chr4	134200000	134700000	-0.08190242007	0.24085037674919269	500000
chr4	134700000	134850000	0.0002455527999999929	0.9884284176533907	150000
chr4	134850000	137700000	-0.13358608992877194	0.0193756727664155	2850000
chr4	137700000	137750000	0.06453263120000002	0.3261571582346609	50000
chr4	137750000	138000000	-0.05641165561999999	0.3579117330462863	250000
chr4	138000000	138950000	0.1981540822157895	0.008073196986006458	950000
chr4	138950000	139850000	-0.08431137602222218	0.06270182992465016	900000
chr4	139850000	139900000	0.1359953073000001	0.098762109795479	50000
chr4	139900000	140300000	-0.0037105750999999465	0.9418729817007535	400000
chr4	140300000	140400000	0.0	0.9938105489773951	100000
chr4	140400000	141300000	0.0049019608	0.8939720129171151	900000
chr4	141300000	141750000	-0.07017011346666671	0.06916038751345532	450000
chr4	141750000	141800000	0.16114741349999995	0.07185145317545748	50000
chr4	141800000	142500000	-0.1892020606857143	0.019644779332615717	700000
chr4	142500000	142700000	0.023723125600000006	0.6994079655543596	200000
chr4	142700000	142950000	-0.1970560952	0.05382131324004306	250000
chr4	142950000	143100000	0.08962675980000001	0.23143164693218515	150000
chr4	143100000	144450000	-0.24039325328148145	0.00511302475780409	1350000
chr4	144450000	144550000	0.35894357740000005	0.005651237890204521	100000
chr4	144550000	146000000	-0.0593459170862069	0.07481162540365985	1450000
chr4	146000000	146900000	0.10091726083333333	0.04198062432723358	900000
chr4	146900000	147300000	-0.2484618847	0.005382131324004306	400000
chr4	147300000	147800000	-0.06928544142	0.2483853606027987	500000
chr4	147800000	147850000	-0.27770312669999997	0.01426264800861141	50000
chr4	147850000	148100000	0.1267495634	0.13213132400430572	250000
chr4	148100000	148250000	-0.06626514250000004	0.31404736275565126	150000
chr4	148250000	148800000	0.07259153659090914	0.11463939720129171	550000
chr4	148800000	150250000	-0.11588855760689659	0.017222820236813777	1450000
chr4	150250000	152700000	0.08294957594693876	0.006996770721205597	2450000
chr4	152700000	152950000	-0.011718323700000033	0.8414962325080731	250000
chr4	152950000	153700000	0.22054867396000005	0.006996770721205597	750000
chr4	153700000	154050000	-0.018024742314285747	0.6463939720129172	350000
chr4	154050000	154500000	0.030738431700000013	0.6122174381054898	450000
chr4	154500000	154750000	0.33447424426	0.005382131324004306	250000
chr4	154750000	154850000	0.5690310215000001	0.0016146393972012918	100000
chr4	154850000	155150000	0.7990866802000002	0.00026910656620021526	300000
chr4	155150000	155250000	0.5059512442	0.002152852529601722	100000
chr4	155250000	155450000	0.3662453618	0.005382131324004306	200000
chr4	155450000	155600000	-0.19809287350000004	0.05382131324004306	150000
chr4	155600000	155900000	-0.5172023355	0.001883745963401507	300000
chr4	155900000	156000000	-0.2653641002	0.01776103336921421	100000
chr4	156000000	156250000	-0.3655496289	0.005382131324004306	250000
chr4	156250000	156300000	-0.1763102968	0.06485468245425188	50000
chr4	156300000	156700000	-0.5145455909	0.001883745963401507	400000
chr4	156700000	157150000	-0.07336078375555556	0.15177610333692143	450000
chr4	157150000	158100000	0.12249744391052629	0.007534983853606028	950000
chr4	158100000	158850000	-0.1714938248133334	0.002960172228202368	750000
chr4	158850000	158900000	0.12815808139999996	0.12836383207750268	50000
chr4	158900000	159600000	-0.22067836873571436	0.026641550053821312	700000
chr4	159600000	159650000	0.03640660809999996	0.556243272335845	50000
chr4	159650000	160100000	-0.03734599901111113	0.5438643702906351	450000
chr4	160100000	160400000	0.03453426830000006	0.5721205597416577	300000
chr4	160400000	160500000	0.36909309180000005	0.00511302475780409	100000
chr4	160500000	160850000	-0.5233002291600001	0.001883745963401507	350000
chr4	160850000	161300000	-0.2186893696644444	0.016684607104413347	450000
chr4	161300000	161400000	-0.31598889553	0.008073196986006458	100000
chr4	161400000	162250000	-0.19563854952411766	0.05543595263724435	850000
chr4	162250000	162350000	-0.34356242493	0.006996770721205597	100000
chr4	162350000	162600000	0.018218651099999983	0.7588805166846071	250000
chr4	162600000	162950000	-0.042443113600000026	0.5131862217438106	350000
chr4	162950000	163100000	0.1358657099	0.098762109795479	150000
chr4	163100000	164700000	-0.1249899817928125	0.02691065662002153	1600000
chr4	164700000	164850000	0.08485553309999999	0.24407965554359526	150000
chr4	164850000	165850000	-0.11100366283500003	0.01318622174381055	1000000
chr4	165850000	166050000	0.07830404889999998	0.2607642626480086	200000
chr4	166050000	166100000	-0.2783135981	0.01426264800861141	50000
chr4	166100000	166350000	0.016677125399999992	0.7814854682454252	250000
chr4	166350000	166400000	0.38616241949999996	0.004036598493003229	50000
chr4	166400000	167200000	-0.28256558303125	0.005651237890204521	800000
chr4	167200000	167500000	0.04050029096666665	0.02691065662002153	300000
chr4	167500000	169350000	-0.1437629412837838	0.01883745963401507	1850000
chr4	169350000	169950000	0.09751116350000001	0.07534983853606028	600000
chr4	169950000	170400000	-0.021660558166666614	0.3129709364908504	450000
chr4	170400000	170700000	0.11960352326666664	0.019106566200215284	300000
chr4	170700000	173900000	-0.152452937854375	0.01883745963401507	3200000
chr4	173900000	174500000	0.06812384047499997	0.01264800861141012	600000
chr4	174500000	175050000	-0.37691605565454545	0.002960172228202368	550000
chr4	175050000	176150000	-0.1380893266409091	0.04198062432723358	1100000
chr4	176150000	176200000	0.12929717340000002	0.1264800861141012	50000
chr4	176200000	176450000	-0.13357047369999997	0.11033369214208827	250000
chr4	176450000	176500000	0.25613540869999996	0.0193756727664155	50000
chr4	176500000	177100000	-0.085078349525	0.18057050592034446	600000
chr4	177100000	177250000	0.26393853	0.01883745963401507	150000
chr4	177250000	177600000	-0.009958528799999922	0.8611410118406889	350000
chr4	177600000	178000000	0.056576039500000064	0.0193756727664155	400000
chr4	178000000	178450000	-0.03520082275555551	0.3579117330462863	450000
chr4	178450000	178500000	0.3371064335	0.006996770721205597	50000
chr4	178500000	180450000	-0.12602383610743587	0.019644779332615717	1950000
chr4	180450000	180650000	0.20556859109999998	0.045479009687836386	200000
chr4	180650000	180950000	-0.051501282300000006	0.4381054897739505	300000
chr4	180950000	181350000	0.17776400335000003	0.01426264800861141	400000
chr4	181350000	182450000	-0.20784398470454546	0.01318622174381055	1100000
chr4	182450000	183700000	0.07271049331199998	0.01318622174381055	1250000
chr4	183700000	184000000	-0.04196223939999999	0.5196447793326158	300000
chr4	184000000	184200000	0.004303994400000066	0.9359526372443487	200000
chr4	184200000	184650000	-0.15717537016666663	0.04278794402583423	450000
chr4	184650000	186750000	0.06894657213095239	0.002960172228202368	2100000
chr4	186750000	186900000	-0.04323774959999993	0.5075349838536061	150000
chr4	186900000	187500000	0.16980655897499997	0.05382131324004306	600000
chr4	187500000	187900000	0.32353495378749997	0.001883745963401507	400000
chr4	187900000	188150000	0.12398709488000001	0.04628632938643703	250000
chr4	188150000	188700000	-0.0996361354272727	0.12405812701829924	550000
chr4	188700000	189100000	0.0918657235625	0.0193756727664155	400000
chr4	189100000	189550000	-0.07913923146666664	0.21555435952637245	450000
chr4	189550000	189700000	0.15295891089999997	0.07831001076426265	150000
chr4	189700000	190050000	0.5793895480285715	0.001076426264800861	350000
chr4	190050000	190950000	0.08811119143333333	0.06297093649085038	900000
chr5	0	450000	-0.16636299746666663	0.022610188895249	450000
chr5	450000	650000	0.0701814059	0.22495706926159129	200000
chr5	850000	1300000	0.051153898877777784	0.22495706926159129	450000
chr5	1300000	1400000	-0.04203763380000003	0.4212936462507155	100000
chr5	1400000	1600000	0.05542825309999999	0.31110475100171725	200000
chr5	1600000	1650000	-0.06932808209999997	0.227819118488838	50000
chr5	1650000	3700000	0.0779653353414634	0.030910131654264452	2050000
chr5	3700000	3800000	-0.03613796395000002	0.28906697195191755	100000
chr5	3800000	8750000	0.10845829499959599	0.0011448196908986834	4950000
chr5	8750000	9000000	-0.15094084419999998	0.04579278763594734	250000
chr5	9000000	9550000	0.08832977100000004	0.03921007441327991	550000
chr5	9550000	10650000	-0.03529096911363639	0.0993131081854608	1100000
chr5	10650000	10800000	0.15277479419999995	0.045506582713222665	150000
chr5	10800000	10900000	-0.2312408004	0.017458500286204923	100000
chr5	10900000	11950000	0.0956506913390476	0.009730967372638809	1050000
chr5	11950000	12250000	-0.12261606399000001	0.05495134516313681	300000
chr5	12250000	13100000	0.18313805050588233	0.01631368059530624	850000
chr5	13100000	13950000	-0.06946451098823529	0.08586147681740126	850000
chr5	13950000	16000000	0.08514210419024391	0.022323983972524327	2050000
chr5	16000000	16200000	-0.09014997809999997	0.14510589582140812	200000
chr5	16200000	16750000	0.1014350450818182	0.03921007441327991	550000
chr5	16750000	16800000	-0.03550940840000005	0.5014310246136233	50000
chr5	16800000	17200000	0.05805784299999994	0.3025186033199771	400000
chr5	17200000	17450000	-0.006400922899999939	0.8981110475100171	250000
chr5	17450000	17550000	0.4395174444	0.0034344590726960505	100000
chr5	17600000	18350000	-0.004927000099999995	0.9210074413279908	750000
chr5	18350000	18750000	0.0436726737375	0.3028048082427018	400000
chr5	18750000	19400000	-0.022969205632307692	0.05924441900400687	650000
chr5	19400000	20750000	-0.38849718358370366	0.002003434459072696	1350000
chr5	20800000	21300000	-0.2898814496	0.009444762449914138	500000
chr5	21350000	22150000	-0.15149431119250004	0.02575844304522038	800000
chr5	22150000	22450000	0.05746509129999999	0.3028048082427018	300000
chr5	22450000	24000000	-0.02279431297129033	0.48683457355466514	1550000
chr5	24000000	24150000	0.04227234754	0.4212936462507155	150000
chr5	24150000	24450000	-0.059768468820000024	0.28620492272467085	300000
chr5	24450000	25050000	-0.17957691847	0.028620492272467088	600000
chr5	25050000	27000000	-0.0762397446569231	0.06067544361763022	1950000
chr5	27000000	28800000	-0.31991961827444443	0.0034344590726960505	1800000
chr5	28800000	29600000	-0.067593587105	0.18918145392100744	800000
chr5	29600000	29700000	0.017718900499999996	0.6934745277618775	100000
chr5	29700000	31550000	-0.2871224608083784	0.004865483686319404	1850000
chr5	31550000	32800000	0.03094816406000002	0.06067544361763022	1250000
chr5	32800000	32850000	-0.19964594019999993	0.024613623354321695	50000
chr5	32850000	33900000	0.05905921268095238	0.010589582140812822	1050000
chr5	33900000	34000000	-0.2691212157	0.01030337721808815	100000
chr5	34000000	34200000	-0.006876317800000087	0.884373211219233	200000
chr5	34250000	34450000	-0.17135000200000006	0.01974813966800229	200000
chr5	34450000	34850000	0.028086088199999915	0.5907269605037206	400000
chr5	34850000	34950000	-0.20973067590000005	0.02346880366342301	100000
chr5	34950000	35250000	0.18771532006666672	0.012020606754436176	300000
chr5	35250000	35950000	-0.05296858927142859	0.045506582713222665	700000
chr5	35950000	36100000	0.05291800929999996	0.32484258729250143	150000
chr5	36100000	36700000	0.5395711501000001	0.0011448196908986834	600000
chr5	36700000	37900000	0.07630617546666665	0.06067544361763022	1200000
chr5	37900000	37950000	0.4297410192	0.0034344590726960505	50000
chr5	37950000	38900000	0.07969715438947372	0.1462507155123068	950000
chr5	38900000	40400000	-0.12657888108333334	0.008299942759015456	1500000
chr5	40400000	42750000	0.12391761234425532	0.0011448196908986834	2350000
chr5	42750000	42900000	-0.08454071689999998	0.1611333714939897	150000
chr5	42900000	43150000	0.1892270359	0.0294791070406411	250000
chr5	43150000	43200000	-0.07588017660000002	0.19977103606182026	50000
chr5	43200000	43450000	0.07718104789999997	0.19404693760732686	250000
chr5	43450000	43700000	0.12591399139999998	0.06954779622209502	250000
chr5	43700000	44050000	0.05917571707000001	0.29021179164281624	350000
chr5	44050000	44150000	0.14104706207	0.04979965655409273	100000
chr5	44150000	44750000	0.012941082869999995	0.7578706353749285	600000
chr5	44750000	45000000	0.43833472568	0.002003434459072696	250000
chr5	45000000	45300000	-0.008931057799999989	0.8196908986834573	300000
chr5	45300000	46400000	0.05264821509272726	0.21379507727532915	1100000
chr5	49450000	50750000	0.09810515299846154	0.01631368059530624	1300000
chr5	50750000	51650000	-0.024402275530555555	0.6001717229536349	900000
chr5	51650000	52200000	0.1500999974618182	0.024899828277046364	550000
chr5	52200000	52800000	-0.10237299595833328	0.005437893531768746	600000
chr5	52800000	53000000	0.03920117750000002	0.44562106468231255	200000
chr5	53000000	54450000	-0.21377897403103444	0.01030337721808815	1450000
chr5	54450000	54500000	0.06552492339999993	0.24241556954779622	50000
chr5	54500000	55000000	-0.07465091299999999	0.14768174012593016	500000
chr5	55000000	55150000	0.23340228873333338	0.01631368059530624	150000
chr5	55150000	55500000	-0.04360902249999998	0.4038351459645106	350000
chr5	55500000	55550000	0.4727175081	0.0028620492272467086	50000
chr5	55550000	55650000	0.07310737160000003	0.2120778477389811	100000
chr5	55650000	56100000	-0.1003819071	0.11419576416714368	450000
chr5	56100000	56250000	0.05512591	0.31110475100171725	150000
chr5	56250000	56450000	-0.05454907110000001	0.31768746422438465	200000
chr5	56450000	56600000	0.36650356049999994	0.005151688609044075	150000
chr5	56600000	58150000	-0.19793813774193553	0.01030337721808815	1550000
chr5	58150000	58250000	0.4343994908	0.0034344590726960505	100000
chr5	58250000	59100000	0.05929716915294113	0.24785346307956496	850000
chr5	59100000	60000000	-0.5036354113222222	0.0011448196908986834	900000
chr5	60000000	60200000	-0.08257150810000002	0.1668574699484831	200000
chr5	60200000	60250000	0.24101523649999995	0.01688609044075558	50000
chr5	60250000	60850000	0.11291853974999999	0.045220377790498	600000
chr5	60850000	60950000	0.677980666	0.0005724098454493417	100000
chr5	60950000	61700000	-0.01483391018000001	0.4261591299370349	750000
chr5	61700000	62650000	0.09607267961684209	0.06325128792215226	950000
chr5	62650000	62800000	0.0	1.0	150000
chr5	62800000	63400000	-0.004081632653000001	0.9298797939324557	600000
chr5	63400000	63550000	0.06175756860000001	0.2641671436748712	150000
chr5	63550000	63850000	-0.05910013120000002	0.29221522610188894	300000
chr5	63850000	64050000	0.15136551705	0.01030337721808815	200000
chr5	64050000	64550000	-0.12031268646	0.035489410417859184	500000
chr5	64550000	65100000	0.041747948545454557	0.3918145392100744	550000
chr5	65100000	65500000	-0.04074471890000009	0.433028048082427	400000
chr5	65500000	65600000	0.5572144646999999	0.0011448196908986834	100000
chr5	65600000	66100000	-0.0080876795	0.8531768746422439	500000
chr5	66100000	68300000	0.24800285343818188	0.0011448196908986834	2200000
chr5	68300000	68350000	-0.531232844	0.0011448196908986834	50000
chr5	68350000	68850000	0.07734415409999998	0.18202633085289066	500000
chr5	70650000	70750000	-0.20709312959999998	0.024327418431597022	100000
chr5	70750000	70900000	0.16620121740000005	0.042072123640526614	150000
chr5	70900000	71050000	-0.14179098539999996	0.04979965655409273	150000
chr5	71050000	71400000	-0.3050324222857143	0.005724098454493417	350000
chr5	71400000	71950000	-0.025829002490909168	0.4971379507727533	550000
chr5	71950000	72100000	-0.4541273819	0.0031482541499713796	150000
chr5	72100000	72400000	0.04152046779999996	0.4261591299370349	300000
chr5	72400000	73150000	-0.02763098224	0.3365769891242129	750000
chr5	73150000	73400000	0.046151092000000005	0.38351459645105895	250000
chr5	73400000	74000000	-0.10682592723333335	0.04979965655409273	600000
chr5	74000000	74050000	0.42763655170000003	0.0034344590726960505	50000
chr5	74050000	74350000	-0.07918606039999998	0.18202633085289066	300000
chr5	74350000	74550000	0.0022079006999999873	0.957355466514024	200000
chr5	74550000	74600000	-0.31615944630000004	0.008299942759015456	50000
chr5	74600000	77550000	0.09303100365423729	0.018317115054378934	2950000
chr5	77550000	77750000	-0.008752038899999981	0.8245563823697768	200000
chr5	77750000	78300000	0.11498406910909091	0.004293073840870063	550000
chr5	78300000	78600000	-0.1763575605333333	0.01974813966800229	300000
chr5	78600000	79000000	0.11702669370000002	0.07498568975386377	400000
chr5	79000000	79250000	-0.06373871190000002	0.24785346307956496	250000
chr5	79250000	79400000	0.09025738949999995	0.14453348597595878	150000
chr5	79400000	83200000	-0.12372451595263156	0.004293073840870063	3800000
chr5	83200000	83750000	0.05166234494545455	0.32169433314253004	550000
chr5	83750000	83800000	-0.2775191948	0.009730967372638809	50000
chr5	83800000	84100000	-0.040784500899999965	0.433028048082427	300000
chr5	84100000	84400000	-0.2418586148	0.01688609044075558	300000
chr5	84400000	86150000	0.07537994645714284	0.07498568975386377	1750000
chr5	86150000	86250000	-0.4034849027	0.004293073840870063	100000
chr5	86250000	88200000	0.20251626216205126	0.009444762449914138	1950000
chr5	88200000	88900000	-0.05001165047142856	0.04579278763594734	700000
chr5	88900000	89300000	0.04796912919999996	0.3686319404693761	400000
chr5	89300000	89500000	-0.08526872730000001	0.15884373211219233	200000
chr5	89500000	89550000	0.1759557625	0.03692043503148254	50000
chr5	89550000	89700000	-0.04236782429999997	0.4212936462507155	150000
chr5	89700000	89900000	0.13160679470000003	0.06267887807670292	200000
chr5	89900000	90100000	-0.03408521310000001	0.5203205495134516	200000
chr5	90100000	90400000	-0.248864224	0.01631368059530624	300000
chr5	90400000	90450000	0.08836774480000009	0.14768174012593016	50000
chr5	90450000	90700000	-0.013673071499999967	0.7510017172295363	250000
chr5	90700000	90750000	0.3312248876	0.006010303377218088	50000
chr5	90750000	91600000	-0.4202457591588235	0.0011448196908986834	850000
chr5	91600000	92400000	-0.2362946055875	0.009730967372638809	800000
chr5	92400000	92950000	0.03325051440909088	0.38179736691471095	550000
chr5	92950000	93900000	-0.1420303055052631	0.01030337721808815	950000
chr5	93900000	93950000	0.06212754109999996	0.25615340583858043	50000
chr5	93950000	94300000	-0.1514540319	0.018317115054378934	350000
chr5	94300000	94800000	-0.39099733464	0.0034344590726960505	500000
chr5	94800000	95050000	-0.07669809446000005	0.03921007441327991	250000
chr5	95050000	95700000	0.01696702071538459	0.14453348597595878	650000
chr5	95700000	95900000	-0.16297489749999994	0.04378935317687464	200000
chr5	95900000	96350000	0.06880295978888896	0.14396107613050946	450000
chr5	96350000	96550000	-0.21207383540000002	0.02318259874069834	200000
chr5	96550000	97350000	0.14002143256875005	0.01631368059530624	800000
chr5	97350000	97400000	-0.10683852490000001	0.0924441900400687	50000
chr5	97400000	97850000	0.029613716800000023	0.563537492844877	450000
chr5	97850000	98050000	-0.22046186890000005	0.018317115054378934	200000
chr5	98050000	98250000	-0.0185702351	0.6846021751574127	200000
chr5	98250000	98400000	0.3079603771	0.008872352604464796	150000
chr5	98400000	98450000	-0.512702390906	0.002003434459072696	50000
chr5	98450000	98750000	-0.088212594976	0.14768174012593016	300000
chr5	98750000	99800000	-0.030875374381714282	0.24785346307956496	1050000
chr5	99800000	99850000	-0.418824839906	0.0034344590726960505	50000
chr5	99850000	100100000	-0.0133667502	0.754722381224957	250000
chr5	100100000	100250000	0.2088554719999999	0.02346880366342301	150000
chr5	100250000	100850000	-0.01584119028	0.7152261018889525	600000
chr5	100850000	101550000	0.025627560967142853	0.4341728677733257	700000
chr5	101550000	101850000	-0.02287862513	0.6293646250715512	300000
chr5	101850000	102350000	0.13240840189000003	0.04436176302232398	500000
chr5	102350000	102900000	-0.14442672338181828	0.024613623354321695	550000
chr5	102900000	103200000	-0.4639495564	0.002003434459072696	300000
chr5	103200000	103250000	-0.24016390180000002	0.017172295363480253	50000
chr5	103250000	105400000	-0.49713356852720936	0.0011448196908986834	2150000
chr5	105400000	106250000	-0.13429652558823527	0.008872352604464796	850000
chr5	106250000	106700000	-0.42818952141111116	0.0011448196908986834	450000
chr5	106700000	106900000	-0.005410351300000005	0.9149971379507728	200000
chr5	106900000	107000000	0.047650873200000055	0.3686319404693761	100000
chr5	107000000	108650000	-0.2006713513060606	0.006296508299942759	1650000
chr5	108650000	108800000	0.012408004199999989	0.76960503720664	150000
chr5	108800000	108950000	-0.21921470350000005	0.022323983972524327	150000
chr5	108950000	109000000	-0.49676572390000007	0.002003434459072696	50000
chr5	109000000	109350000	-0.08935831640000003	0.1462507155123068	350000
chr5	109350000	109450000	0.04941719379999998	0.3526044647967945	100000
chr5	109450000	110500000	-0.4206263959523809	0.0028620492272467086	1050000
chr5	110500000	111400000	-0.21602020923333332	0.006010303377218088	900000
chr5	111400000	111500000	-0.495273899	0.002003434459072696	100000
chr5	111500000	111550000	0.14146079490000002	0.04979965655409273	50000
chr5	111550000	111850000	-0.05931893219999997	0.29021179164281624	300000
chr5	111850000	112000000	0.170700561	0.040641099026903264	150000
chr5	112000000	112200000	-0.12521780639999996	0.07183743560389239	200000
chr5	112200000	112250000	0.3504157218	0.005437893531768746	50000
chr5	112250000	112950000	-0.0825237697857143	0.044647967945048654	700000
chr5	112950000	113500000	0.0030751481899999977	0.9419004006868918	550000
chr5	113500000	114100000	-0.015148983570666666	0.6491127647395535	600000
chr5	114100000	116200000	0.11252981281700002	0.03606182026330853	2100000
chr5	116200000	117000000	-0.0027700700163125	0.40927303949627936	800000
chr5	117000000	117050000	0.0038071368890000004	0.9324556382369776	50000
chr5	117050000	117600000	-0.000274495764	0.9934172867773325	550000
chr5	117600000	117800000	0.05430640092	0.31969089868345735	200000
chr5	117800000	118600000	-0.06104845446437501	0.017458500286204923	800000
chr5	118600000	118750000	0.11023988549999997	0.08900973096737264	150000
chr5	118750000	119350000	-0.27552611688333334	0.01030337721808815	600000
chr5	119350000	120150000	-0.05177179060625	0.1462507155123068	800000
chr5	120150000	121300000	-0.30888418423913055	0.005437893531768746	1150000
chr5	121300000	121800000	0.043169431499999994	0.27561534058385806	500000
chr5	121800000	122050000	-0.08370370368	0.0294791070406411	250000
chr5	122050000	123850000	0.06195272134444442	0.01631368059530624	1800000
chr5	123850000	123900000	-0.34607550619999994	0.005724098454493417	50000
chr5	123900000	125250000	0.0736575418518518	0.017172295363480253	1350000
chr5	125250000	125300000	-0.04545092890000002	0.38866628506010303	50000
chr5	125300000	125500000	0.03642041610000002	0.48282770463651975	200000
chr5	125500000	125700000	-0.04740024669999998	0.3714939896966228	200000
chr5	125700000	125950000	0.03555316860000002	0.4977103606182026	250000
chr5	125950000	126100000	-0.014782989199999985	0.7389811104751002	150000
chr5	126100000	126900000	0.11914160401874996	0.01659988551803091	800000
chr5	126900000	127100000	-0.011234435300000012	0.7899255867200916	200000
chr5	127100000	127200000	-0.31123443529999995	0.008299942759015456	100000
chr5	127200000	127450000	-0.04651708637999996	0.3105323411562679	250000
chr5	127450000	128400000	0.12091381336842105	0.03319977103606182	950000
chr5	128400000	128500000	-0.055475991500000016	0.31110475100171725	100000
chr5	128500000	128950000	0.020219419805555555	0.08900973096737264	450000
chr5	128950000	130450000	-0.14911869621700002	0.009730967372638809	1500000
chr5	130450000	131300000	0.10092060212352942	0.03692043503148254	850000
chr5	131300000	131500000	-0.29586665070000007	0.009444762449914138	200000
chr5	131500000	131850000	0.03746668259999997	0.47109330280480827	350000
chr5	131850000	132100000	-0.0813502009	0.1720091585575272	250000
chr5	132100000	132400000	0.012217050499999993	0.76960503720664	300000
chr5	132400000	132700000	-0.04669610530000001	0.38179736691471095	300000
chr5	132700000	133000000	0.04524008429999998	0.3918145392100744	300000
chr5	133000000	133100000	-0.08129052790000002	0.1720091585575272	100000
chr5	133100000	133750000	0.04165480863846146	0.14396107613050946	650000
chr5	133750000	133950000	-0.008008115500000024	0.8531768746422439	200000
chr5	133950000	134250000	0.00594343001666664	0.6491127647395535	300000
chr5	134250000	134450000	-0.09772446990000005	0.12106468231253578	200000
chr5	134450000	134500000	0.0328798186	0.529479107040641	50000
chr5	134500000	134750000	-0.0079365079	0.8531768746422439	250000
chr5	134750000	134850000	0.3655328798	0.005151688609044075	100000
chr5	134850000	135250000	-0.024330668	0.6187750429307384	400000
chr5	135250000	135550000	0.03863627319999996	0.45306239267315396	300000
chr5	135550000	135600000	0.5406770894999999	0.0011448196908986834	50000
chr5	135600000	136050000	-0.018777101499999976	0.6805953062392673	450000
chr5	136050000	136350000	0.11757568530000002	0.07498568975386377	300000
chr5	136350000	136850000	-0.06663881934999999	0.1491127647395535	500000
chr5	136850000	137250000	-0.3814536341	0.004865483686319404	400000
chr5	137250000	137450000	0.06470939249999996	0.24785346307956496	200000
chr5	137450000	137700000	-0.14889604963999997	0.04579278763594734	250000
chr5	137700000	137750000	0.07176671840000004	0.2192329708070979	50000
chr5	137750000	138050000	-0.04251899589999997	0.42014882655981683	300000
chr5	138050000	138700000	0.008189276584615367	0.5621064682312535	650000
chr5	138700000	138800000	-0.10862672549999997	0.09129937034917	100000
chr5	138850000	139750000	-0.08423108037777777	0.04579278763594734	900000
chr5	139750000	140100000	0.08373712060000005	0.1631368059530624	350000
chr5	140100000	140700000	-0.020050125400000007	0.6571265025758443	600000
chr5	140700000	140800000	0.41659704810000003	0.003720663995420721	100000
chr5	140800000	140850000	0.7811194653	0.0005724098454493417	50000
chr5	140850000	140950000	0.1892827306	0.0294791070406411	100000
chr5	140950000	141550000	-0.11875323235000002	0.045220377790498	600000
chr5	141550000	142250000	0.017132400128571375	0.340011448196909	700000
chr5	142250000	142750000	-0.003624139699999973	0.936462507155123	500000
chr5	142750000	143050000	0.028332736599999908	0.5861476817401259	300000
chr5	143050000	144600000	-0.1519783842580645	0.024327418431597022	1550000
chr5	144600000	144750000	0.010820702500000001	0.7930738408700629	150000
chr5	144750000	144850000	-0.26468950159999993	0.01030337721808815	100000
chr5	144850000	145100000	0.05304928980000001	0.3239839725243274	250000
chr5	145100000	145600000	-0.041174364399999996	0.4261591299370349	500000
chr5	145600000	145650000	0.15678481919999998	0.044647967945048654	50000
chr5	145650000	146400000	-0.08810253146666666	0.03434459072696051	750000
chr5	146400000	146950000	0.2074088540363637	0.02346880366342301	550000
chr5	146950000	147700000	-0.06338756944	0.019461934745277618	750000
chr5	147700000	147750000	0.10384691889999997	0.0981682884945621	50000
chr5	147750000	148100000	-0.07253792081428574	0.024613623354321695	350000
chr5	148100000	148600000	0.013891872559999996	0.7120778477389811	500000
chr5	148600000	148800000	-0.10018896445	0.09158557527189468	200000
chr5	148800000	148950000	0.0420973067999999	0.4212936462507155	150000
chr5	148950000	149400000	-0.06834944505555557	0.10246136233543217	450000
chr5	149400000	152000000	0.0968217246434615	0.004006868918145392	2600000
chr5	152000000	152400000	-0.1116292716025	0.07183743560389239	400000
chr5	152400000	153850000	0.06325981893344829	0.005437893531768746	1450000
chr5	153850000	154100000	-0.13855352665999998	0.01030337721808815	250000
chr5	154100000	155500000	0.05013738996571428	0.09502003434459072	1400000
chr5	155500000	155750000	-0.007741576159999999	0.8603319977103606	250000
chr5	155750000	156450000	0.06573406306142855	0.21637092157985116	700000
chr5	156450000	156500000	0.35072204319	0.005437893531768746	50000
chr5	156500000	156700000	0.08745673709999996	0.1491127647395535	200000
chr5	156700000	156750000	0.4773202849	0.0028620492272467086	50000
chr5	156750000	157150000	0.05560080760000001	0.07212364052661706	400000
chr5	157150000	157300000	0.5870589172	0.0011448196908986834	150000
chr5	157300000	157750000	0.05619471966666667	0.2976531196336577	450000
chr5	157750000	157950000	0.20401400320000002	0.024327418431597022	200000
chr5	157950000	158150000	0.0995822891	0.11419576416714368	200000
chr5	158150000	158200000	0.1710108605	0.040641099026903264	50000
chr5	158200000	158850000	0.07431735627692307	0.1720091585575272	650000
chr5	158850000	159150000	0.30105886415	0.0028620492272467086	300000
chr5	159150000	159200000	-0.016986911699999996	0.6983400114481969	50000
chr5	159200000	159650000	0.10791219676666662	0.017458500286204923	450000
chr5	159650000	159850000	-0.08219357919999992	0.1688609044075558	200000
chr5	159850000	159900000	0.6014798902	0.0008586147681740126	50000
chr5	159900000	160450000	0.0771134184	0.19404693760732686	550000
chr5	160450000	161050000	-0.014724310776666668	0.607899255867201	600000
chr5	161050000	161300000	0.00922544455999999	0.818259874069834	250000
chr5	161300000	161550000	-0.014166368310000005	0.7432741843159703	250000
chr5	161550000	161850000	0.03714710056166667	0.4261591299370349	300000
chr5	161850000	162750000	-0.07243107769277778	0.0658271322266743	900000
chr5	162750000	162800000	0.39354338230999997	0.004293073840870063	50000
chr5	162800000	162950000	-0.08196682179999998	0.1688609044075558	150000
chr5	162950000	163000000	0.33640052519999997	0.005724098454493417	50000
chr5	163000000	163900000	-0.10929130584055557	0.024613623354321695	900000
chr5	163900000	164000000	0.03550940839	0.5014310246136233	100000
chr5	164000000	165700000	-0.05356247763411765	0.1462507155123068	1700000
chr5	165700000	166100000	0.0327366034	0.4793932455638237	400000
chr5	166100000	167250000	-0.09645611613913044	0.02289639381797367	1150000
chr5	167250000	168050000	0.10413036558124997	0.04579278763594734	800000
chr5	168050000	168350000	-0.010255798300000007	0.8085289066971952	300000
chr5	168350000	168400000	0.026781238799999996	0.6070406410990269	50000
chr5	168400000	168800000	-0.06901579341249997	0.19175729822552948	400000
chr5	168800000	169000000	0.037956001100000025	0.4653692043503148	200000
chr5	169000000	169400000	-0.006078688699999946	0.9084144247281053	400000
chr5	169400000	169450000	0.3204519235	0.008299942759015456	50000
chr5	169450000	169700000	-0.007033456700000051	0.8775042930738409	250000
chr5	169700000	170100000	0.1954031904875	0.01631368059530624	400000
chr5	170100000	170750000	0.05035237666923075	0.11419576416714368	650000
chr5	170750000	170800000	0.4618251979	0.0028620492272467086	50000
chr5	170800000	170950000	0.18019254480000002	0.03434459072696051	150000
chr5	170950000	171250000	-0.03228308870000002	0.5334859759587864	300000
chr5	171250000	171900000	0.1574387740076923	0.003720663995420721	650000
chr5	171900000	172400000	-0.03251979156000001	0.04579278763594734	500000
chr5	172400000	172750000	0.04689103709999998	0.38179736691471095	350000
chr5	172750000	173000000	-0.008211003700000052	0.8531768746422439	250000
chr5	173000000	173150000	0.12036042489999998	0.07298225529479108	150000
chr5	173150000	173200000	-0.05106814660000003	0.34315970234688037	50000
chr5	173200000	175350000	0.12819988321627906	0.01030337721808815	2150000
chr5	175550000	175650000	0.16789195209999996	0.041499713795077275	100000
chr5	175700000	175750000	0.16789195209999996	0.041499713795077275	50000
chr5	175750000	175800000	-0.1872100887	0.030623926731539783	50000
chr5	175800000	177150000	0.05534331126296297	0.009730967372638809	1350000
chr5	177350000	177550000	0.06267752720000003	0.2200915855752719	200000
chr5	177550000	177700000	0.2401639018	0.017172295363480253	150000
chr5	177700000	178050000	0.47316874948571425	0.0022896393817973667	350000
chr5	178050000	178550000	0.15501452040000002	0.022610188895249	500000
chr5	178550000	178950000	0.2568365358	0.012020606754436176	400000
chr5	178950000	179000000	0.6291562239	0.0008586147681740126	50000
chr5	179000000	179300000	0.1067072443	0.0924441900400687	300000
chr5	179300000	179350000	-0.08237657630000006	0.1688609044075558	50000
chr5	179350000	180700000	0.1401370858185185	0.0034344590726960505	1350000
chr6	150000	450000	0.01857509530000001	0.6848777543012375	300000
chr6	450000	500000	-0.14910167239999994	0.055236945366737095	50000
chr6	500000	1050000	0.057821508700000024	0.013281014186537881	550000
chr6	1050000	1300000	-0.05780758399999997	0.3099909447630546	250000
chr6	1300000	1350000	0.10380857760000006	0.12677331723513433	50000
chr6	1350000	1550000	-0.004797979799999963	0.8786598249320857	200000
chr6	1550000	2800000	0.266808577596	0.00724418955629339	1250000
chr6	2800000	3250000	-0.10298476567777781	0.0479927558104437	450000
chr6	3250000	3700000	-0.5088880609	0.0012073649260488982	450000
chr6	3700000	4050000	-0.18282532582857142	0.01388469664956233	350000
chr6	4050000	4150000	0.0013702599999999565	0.9695140356172653	100000
chr6	4150000	4700000	-0.26922767160909095	0.00784787201931784	550000
chr6	4700000	5050000	-0.06247959689999998	0.18714156353757924	350000
chr6	5050000	5300000	0.0739319423	0.24237850890431634	250000
chr6	5300000	5800000	0.2890958768000001	0.006942348324781165	500000
chr6	5800000	6000000	0.07293426070000003	0.24841533353456083	200000
chr6	6000000	6050000	-0.13312634539999996	0.06821611832176275	50000
chr6	6050000	6600000	0.09907570486363639	0.062481134923030486	550000
chr6	6600000	6650000	-0.1466302368	0.05916088137639602	50000
chr6	6650000	7050000	0.09175360159999996	0.17265318442499245	400000
chr6	7050000	7100000	-0.05783656240000001	0.3099909447630546	50000
chr6	7100000	7250000	0.21287050829999998	0.016299426501660125	150000
chr6	7250000	7300000	-0.020736049000000034	0.6625415031693329	50000
chr6	7300000	7600000	-0.33588756410000004	0.005734983398732267	300000
chr6	7600000	8400000	-0.14942353865000002	0.024147298520977967	800000
chr6	8400000	9200000	0.16857871749999997	0.026260187141563536	800000
chr6	9200000	9600000	-0.05043260474999997	0.1536371868397223	400000
chr6	9600000	10400000	-0.27394979506250006	0.0018110473890733474	800000
chr6	10400000	10800000	0.08554085942499998	0.07606399034108059	400000
chr6	10800000	10850000	-0.0939476735	0.16661635979474795	50000
chr6	10850000	11600000	0.1973160567133334	0.00724418955629339	750000
chr6	11600000	11650000	-0.01967213109999999	0.6703893751886507	50000
chr6	11650000	12150000	0.02396423249999997	0.5997585270147903	500000
chr6	12150000	12350000	-0.03859082629999999	0.4424992453969212	200000
chr6	12350000	12600000	0.08231081310000005	0.21460911560519166	250000
chr6	12600000	12650000	-0.20657807579999998	0.01931783881678237	50000
chr6	12650000	13300000	0.07132548695384615	0.005734983398732267	650000
chr6	13300000	13600000	-0.09997930119999998	0.14337458496830668	300000
chr6	13600000	13750000	0.06990809743333333	0.12677331723513433	150000
chr6	13750000	13900000	-0.23050173863333331	0.00784787201931784	150000
chr6	13900000	14100000	0.01065987749999997	0.8025958345910051	200000
chr6	14100000	15250000	-0.18049003935217386	0.01056444310292786	1150000
chr6	15250000	15500000	0.019920516699999946	0.6688801690310896	250000
chr6	15500000	15650000	0.2371336314	0.010866284334440085	150000
chr6	15650000	15700000	0.5547565822	0.0006036824630244491	50000
chr6	15700000	16600000	0.07787851187777776	0.18140658013884697	900000
chr6	16600000	16750000	0.10471104489999994	0.12586779354059766	150000
chr6	16750000	17600000	-0.08426088269411769	0.005734983398732267	850000
chr6	17600000	18550000	0.03863048082631578	0.2816178690009055	950000
chr6	18550000	18600000	0.6319961914	0.00030184123151222455	50000
chr6	18600000	18800000	-0.0124482531	0.771506187745246	200000
chr6	18800000	19250000	0.09311696199000001	0.12677331723513433	450000
chr6	19250000	19450000	0.47078572609999997	0.0018110473890733474	200000
chr6	19450000	19650000	0.161694817	0.044974343495321464	200000
chr6	19650000	19850000	0.23712121210000003	0.010866284334440085	200000
chr6	19850000	20050000	0.03167742999999998	0.5064895864775129	200000
chr6	20050000	20100000	0.2821824805	0.00724418955629339	50000
chr6	20100000	20550000	-0.2198666998	0.013281014186537881	450000
chr6	20550000	21300000	0.23746481208000011	0.01056444310292786	750000
chr6	21300000	21550000	0.005592813399999952	0.8780561424690613	250000
chr6	21550000	21650000	-0.15424325220000001	0.0492001207364926	100000
chr6	21650000	22800000	-0.3795276355652173	0.0018110473890733474	1150000
chr6	22800000	23650000	-0.22645500324705883	0.00784787201931784	850000
chr6	23650000	23750000	-0.3479052823	0.005433142167220043	100000
chr6	23750000	24250000	0.06582463984	0.06972532447932388	500000
chr6	24250000	24600000	-0.04897334000000003	0.3730757621491096	350000
chr6	24600000	24800000	0.13272996355000005	0.01056444310292786	200000
chr6	24800000	25000000	-0.02311641000000003	0.6151524298219136	200000
chr6	25000000	25600000	0.24944665230000004	0.005433142167220043	600000
chr6	25600000	25950000	-0.020305514199999986	0.6664654391789918	350000
chr6	25950000	26000000	0.5554520616	0.0006036824630244491	50000
chr6	26000000	26350000	-0.006023348199999945	0.869604587986719	350000
chr6	26350000	26600000	0.015764199399999956	0.7259281617869001	250000
chr6	26600000	26700000	-0.08202723959999997	0.21460911560519166	100000
chr6	26950000	27050000	-0.08202723959999997	0.21460911560519166	100000
chr6	27050000	28550000	0.06032559197666667	0.00724418955629339	1500000
chr6	28550000	28600000	-0.09422089750000001	0.16661635979474795	50000
chr6	28600000	28800000	0.07951647629999997	0.22185330516148505	200000
chr6	28800000	29000000	0.19904785560000005	0.020827044974343494	200000
chr6	29000000	29450000	0.049230004970000005	0.3703591910654995	450000
chr6	29450000	29550000	0.44518960097	0.002112888620585572	100000
chr6	29550000	31450000	-0.06803845181578945	0.02384545728946574	1900000
chr6	31450000	31600000	0.060368024500000006	0.2976154542710534	150000
chr6	31700000	31850000	0.060368024500000006	0.2976154542710534	150000
chr6	31900000	31950000	0.1402860573	0.06368849984907939	50000
chr6	32050000	32450000	0.10069185711249999	0.06368849984907939	400000
chr6	32500000	32750000	0.0021878623000000097	0.9444612134017507	250000
chr6	32750000	32800000	0.2870363471	0.00724418955629339	50000
chr6	32800000	33550000	-0.012193243879999998	0.6362813160277694	750000
chr6	33550000	33650000	0.06740768340000003	0.2689405372773921	100000
chr6	33850000	33950000	-0.08491058119999995	0.20706308481738606	100000
chr6	34150000	34500000	0.035449341185714266	0.44521581648053127	350000
chr6	34550000	35300000	0.06501890492000004	0.06610322970117719	750000
chr6	35350000	35500000	0.1391020865	0.06610322970117719	150000
chr6	35500000	36700000	-0.12744461347083333	0.010866284334440085	1200000
chr6	36750000	37050000	-0.004735193433333285	0.8680953818291579	300000
chr6	37050000	37250000	0.07039658879999999	0.2592816178690009	200000
chr6	37250000	37750000	-0.014058619020000029	0.5004527618472684	500000
chr6	37750000	38150000	0.010332836499999942	0.8056142469061274	400000
chr6	38150000	38350000	0.09230004959999993	0.16872924841533354	200000
chr6	38350000	38650000	0.009471766799999948	0.8116510715363718	300000
chr6	38650000	38700000	0.6611111111	0.00030184123151222455	50000
chr6	38700000	38950000	0.0287878788	0.5559915484455177	250000
chr6	38950000	39300000	0.09441132637142856	0.04346513733776034	350000
chr6	39300000	41100000	-0.08152184413055558	0.00724418955629339	1800000
chr6	41100000	41650000	0.0905421577818182	0.12586779354059766	550000
chr6	41650000	42050000	-0.16117734722500002	0.04316329610624811	400000
chr6	42050000	43150000	0.05784333651818181	0.12586779354059766	1100000
chr6	43150000	43400000	-0.18354694485999998	0.012073649260488983	250000
chr6	43400000	43600000	0.0370591158000001	0.45125264111077573	200000
chr6	43600000	44650000	-0.06427033805238093	0.043766978569272565	1050000
chr6	44650000	45700000	0.0650085948904762	0.058859040144883794	1050000
chr6	45700000	45950000	-0.05220235140000001	0.34711741623905823	250000
chr6	45950000	47300000	0.1454134545177778	0.006942348324781165	1350000
chr6	47300000	47550000	-0.11383093219999996	0.10624811349230305	250000
chr6	47550000	48350000	0.03708395430000001	0.3087835798370057	800000
chr6	48350000	48650000	-0.16720897503333332	0.01388469664956233	300000
chr6	48650000	48700000	0.050972843200000006	0.3528523996377905	50000
chr6	48700000	49250000	-0.05768489662727272	0.2272864473287051	550000
chr6	49250000	49850000	0.08330918476249997	0.0504074856625415	600000
chr6	49850000	50150000	-0.02189932107166667	0.6127376999698159	300000
chr6	50150000	52550000	0.05751400617791667	0.001509206157561123	2400000
chr6	52550000	52800000	-0.07641165754	0.043766978569272565	250000
chr6	52800000	53700000	0.1274475170722222	0.024147298520977967	900000
chr6	53700000	53800000	-0.1389178672	0.06610322970117719	100000
chr6	53800000	54200000	0.027065739330000005	0.5704799275581044	400000
chr6	54200000	55250000	-0.03768421924185713	0.07998792635073951	1050000
chr6	55250000	55300000	0.14704007288	0.05916088137639602	50000
chr6	55300000	55600000	-0.11320582879999998	0.10624811349230305	300000
chr6	55600000	55650000	0.1393194237	0.06610322970117719	50000
chr6	55650000	55900000	-0.14305762545999995	0.006942348324781165	250000
chr6	55900000	56800000	0.026584837483333314	0.35587081195291276	900000
chr6	56800000	57200000	-0.003721642699999972	0.9003923936009659	400000
chr6	57200000	57950000	0.03919840484	0.21823121038333837	750000
chr6	58000000	58050000	0.08029682070000001	0.21823121038333837	50000
chr6	58150000	58200000	-0.0121150025	0.7727135526712949	50000
chr6	58300000	58800000	-0.0121150025	0.7727135526712949	500000
chr6	61900000	62100000	0.0005567974000000031	0.9921521279806822	200000
chr6	62200000	62300000	0.013364174470000004	0.5852701479022034	100000
chr6	62300000	63700000	-0.04309074350035713	0.24479323875641412	1400000
chr6	63700000	64600000	0.05582969952999998	0.009658919408391186	900000
chr6	64600000	65100000	-0.29225865208999996	0.005734983398732267	500000
chr6	65100000	65500000	-0.10597574104999999	0.11832176275279203	400000
chr6	65500000	66000000	-0.18974167905	0.026260187141563536	500000
chr6	66000000	67350000	-0.0858792846511111	0.08391186236039844	1350000
chr6	67350000	68900000	-0.30937681949516116	0.004829459704195593	1550000
chr6	68900000	70350000	-0.05114485726620689	0.2272864473287051	1450000
chr6	70350000	70400000	-0.1743252194	0.0356172653184425	50000
chr6	70400000	71000000	0.09463383842999999	0.024147298520977967	600000
chr6	71000000	71050000	-0.120649114	0.09538182915786296	50000
chr6	71050000	71900000	0.21327206491764703	0.004527618472683369	850000
chr6	71900000	72000000	-0.13395429710000006	0.0676124358587383	100000
chr6	72000000	72850000	0.18812960857647054	0.011771808028976758	850000
chr6	72850000	72950000	-0.1721270078	0.03773015393902807	100000
chr6	72950000	73800000	0.10317032428823529	0.03380621792936915	850000
chr6	73800000	74150000	-0.059400799600000095	0.06851795955327497	350000
chr6	74150000	74200000	0.18898824309999995	0.026260187141563536	50000
chr6	74200000	74550000	-0.0036347076999999617	0.901901599758527	350000
chr6	74550000	75050000	0.34362063249999997	0.005433142167220043	500000
chr6	75050000	76000000	0.12061599604736843	0.07425294295200724	950000
chr6	76000000	76300000	0.5128829276999999	0.0012073649260488982	300000
chr6	76300000	76600000	0.28054313629999994	0.00724418955629339	300000
chr6	76600000	76650000	-0.5639013081400001	0.0006036824630244491	50000
chr6	76650000	77350000	0.0016724623300000026	0.9628735285239963	700000
chr6	77350000	78200000	-0.05577033595999998	0.10956836703893752	850000
chr6	78200000	78800000	0.0391938511	0.24841533353456083	600000
chr6	78800000	78900000	-0.041368604099999984	0.418050105644431	100000
chr6	78900000	80800000	0.14428037928684218	0.004527618472683369	1900000
chr6	80800000	81400000	-0.013226527533333329	0.6655599154844551	600000
chr6	81400000	82450000	-0.27609072775238097	0.0018110473890733474	1050000
chr6	82450000	82950000	-0.07632472265999997	0.16661635979474795	500000
chr6	82950000	83450000	0.13528729923000005	0.004527618472683369	500000
chr6	83450000	83500000	-0.09956532540000002	0.14578931482040447	50000
chr6	83500000	83950000	0.07843691927777778	0.06610322970117719	450000
chr6	83950000	84500000	-0.061669978454545464	0.043766978569272565	550000
chr6	84500000	85150000	0.05486198675384613	0.24026562028373075	650000
chr6	85150000	85350000	-0.01925815529999997	0.6752188348928464	200000
chr6	85350000	85400000	-0.3808743169	0.004829459704195593	50000
chr6	85400000	87750000	0.05597155722297873	0.06700875339571385	2350000
chr6	87750000	87800000	-0.30801457196	0.006942348324781165	50000
chr6	87800000	88200000	0.1566318927	0.0479927558104437	400000
chr6	88200000	88250000	-0.1364008942	0.06610322970117719	50000
chr6	88250000	88450000	0.18885163100000002	0.026260187141563536	200000
chr6	88450000	88650000	-0.08993624769999997	0.18714156353757924	200000
chr6	88650000	89300000	0.07472327306923078	0.06610322970117719	650000
chr6	89300000	89350000	-0.08244742509999997	0.21460911560519166	50000
chr6	89350000	90100000	0.24914803771999997	0.006942348324781165	750000
chr6	90100000	90600000	0.1066492797	0.09749471777844854	500000
chr6	90600000	91350000	0.2152936468826666	0.005734983398732267	750000
chr6	91350000	92400000	0.021694107352380955	0.5019619680048295	1050000
chr6	92400000	94450000	-0.02364690487902439	0.3878659824932086	2050000
chr6	94450000	95000000	0.12540118021454544	0.006942348324781165	550000
chr6	95000000	95700000	-0.03290205923642856	0.3087835798370057	700000
chr6	95800000	95950000	-0.030926063919999996	0.5113190461817084	150000
chr6	95950000	96100000	0.05427637029999999	0.326592212496227	150000
chr6	96100000	96600000	-0.026107385333	0.07455478418351946	500000
chr6	96600000	97400000	0.03642392157875	0.12586779354059766	800000
chr6	97400000	97600000	-0.05130505884999999	0.043766978569272565	200000
chr6	97600000	98100000	0.032268587492000005	0.39993963175369757	500000
chr6	98100000	99250000	-0.008909479686782608	0.30153939028071236	1150000
chr6	99250000	99450000	0.1275749296	0.07455478418351946	200000
chr6	99450000	99750000	-0.03940014905	0.10836100211288863	300000
chr6	99750000	100050000	0.07131147539999994	0.2538484757017809	300000
chr6	100050000	100550000	-0.031176519319999985	0.412616963477211	500000
chr6	100550000	100600000	-0.5725699619	0.0006036824630244491	50000
chr6	100600000	100800000	0.015308825999999942	0.7313613039541201	200000
chr6	100800000	101100000	-0.06893111440000003	0.11439782674313312	300000
chr6	101100000	101350000	0.02591074680000005	0.587383036522789	250000
chr6	101350000	103800000	-0.3016317406244898	0.003018412315122246	2450000
chr6	103800000	104950000	0.021123746368	0.5852701479022034	1150000
chr6	104950000	105100000	-0.25655323732	0.009658919408391186	150000
chr6	105100000	105150000	0.1232447425	0.08572290974947178	50000
chr6	105150000	105500000	-0.030443782099999983	0.5209779655900996	350000
chr6	105500000	105550000	-0.3644601755	0.005433142167220043	50000
chr6	105550000	105850000	0.09210548100000004	0.16872924841533354	300000
chr6	105850000	106150000	-0.08600761716666662	0.11439782674313312	300000
chr6	106150000	106700000	0.05941945534545452	0.1919710232417748	550000
chr6	106700000	106900000	-0.12724581880000002	0.01056444310292786	200000
chr6	106900000	107100000	0.14966674940000002	0.00784787201931784	200000
chr6	107100000	107350000	-0.18096125190000006	0.03350437669785693	250000
chr6	107350000	108150000	0.18762315778124994	0.006942348324781165	800000
chr6	108150000	108650000	-0.009273058480000063	0.650467853908844	500000
chr6	108650000	109450000	0.06894120511250001	0.12677331723513433	800000
chr6	109450000	110000000	-0.02147217326363637	0.48686990642921824	550000
chr6	110000000	111350000	0.10937287262592592	0.010262601871415635	1350000
chr6	111350000	111800000	-0.07142324896666667	0.16480531240567461	450000
chr6	111800000	112350000	0.005774962709090937	0.8056142469061274	550000
chr6	112350000	113100000	-0.1253121377466666	0.026260187141563536	750000
chr6	113100000	113650000	0.04964812054545453	0.260790824026562	550000
chr6	113650000	114250000	-0.0382679252	0.4437066103229701	600000
chr6	114250000	114350000	0.4268960091999999	0.002112888620585572	100000
chr6	114350000	114450000	-0.5246191422800001	0.0009055236945366737	100000
chr6	114450000	115300000	-2.8978307999999887e-05	0.9990944763054633	850000
chr6	115300000	116300000	0.005454545454850001	0.869604587986719	1000000
chr6	116300000	116400000	-0.342300049639	0.005734983398732267	100000
chr6	116400000	116550000	0.43345752609999993	0.002112888620585572	150000
chr6	116550000	116750000	0.13017883749999992	0.06972532447932388	200000
chr6	116750000	117050000	-0.021336314000000023	0.653184424992454	300000
chr6	117050000	117550000	0.02416169900000001	0.579233323271959	500000
chr6	117550000	117750000	-0.0840536512	0.20917597343797162	200000
chr6	117750000	118200000	0.08693170322222223	0.1964986417144582	450000
chr6	118200000	118350000	0.23332091409999997	0.011771808028976758	150000
chr6	118350000	119250000	0.1206468142	0.047087232115907034	900000
chr6	119250000	119700000	0.3383341613111111	0.002112888620585572	450000
chr6	119700000	120050000	-0.10041515867142856	0.020827044974343494	350000
chr6	120050000	122650000	0.06730490592134616	0.003018412315122246	2600000
chr6	122650000	122800000	-0.0022189104000000515	0.9381225475399939	150000
chr6	122800000	123200000	0.22741347907500004	0.009658919408391186	400000
chr6	123200000	123700000	-0.005412733902	0.7702988228191971	500000
chr6	123700000	124050000	0.03936318690285714	0.412616963477211	350000
chr6	124050000	124200000	-0.058188441830000014	0.3099909447630546	150000
chr6	124200000	124750000	0.04836027938727273	0.06036824630244492	550000
chr6	124750000	125150000	-0.03310564663	0.489284636281316	400000
chr6	125150000	125200000	0.7305307170500001	0.00030184123151222455	50000
chr6	125200000	125650000	0.07410995200000003	0.1388469664956233	450000
chr6	125650000	126050000	-0.21653419435000004	0.00784787201931784	400000
chr6	126050000	126100000	0.2735924822	0.007546030787805615	50000
chr6	126100000	126300000	-0.19157145229999994	0.024147298520977967	200000
chr6	126300000	126400000	0.007199039500000004	0.8430425596136433	100000
chr6	126400000	127850000	-0.2922091177448276	0.0018110473890733474	1450000
chr6	127850000	127900000	0.020856101999999987	0.6577120434651373	50000
chr6	127900000	128150000	-0.2700529889	0.00784787201931784	250000
chr6	128150000	128500000	0.03129657230000005	0.5089043163296106	350000
chr6	128500000	129050000	-0.06988702222727274	0.04769091457893148	550000
chr6	129050000	129100000	0.12138185130000001	0.0932689405372774	50000
chr6	129100000	130300000	-0.1349707801916667	0.01056444310292786	1200000
chr6	130300000	130700000	0.03547358835	0.06368849984907939	400000
chr6	130700000	131000000	-0.10588259649999998	0.1252641110775732	300000
chr6	131000000	131200000	0.03381768499999993	0.47872019317838815	200000
chr6	131200000	131450000	-0.05130816360000001	0.3513431934802294	250000
chr6	131450000	131500000	-0.5139344262	0.0012073649260488982	50000
chr6	131500000	131900000	-0.05081967209999999	0.3528523996377905	400000
chr6	131900000	132250000	0.06768918690000003	0.2689405372773921	350000
chr6	132250000	132550000	-0.028691284433333315	0.3130093570781769	300000
chr6	132550000	132850000	0.0569506541	0.31512224569876246	300000
chr6	132850000	133000000	-0.08742341450000002	0.1964986417144582	150000
chr6	133000000	133900000	0.08510307997222223	0.01388469664956233	900000
chr6	133900000	134250000	-0.2698087431	0.00784787201931784	350000
chr6	134250000	134900000	-0.03466092192307686	0.3048596438273468	650000
chr6	134900000	135000000	0.01726279190000002	0.7105342589797766	100000
chr6	135000000	136650000	-0.14271879248787878	0.02112888620585572	1650000
chr6	136650000	137150000	0.03421924165000001	0.32719589495925144	500000
chr6	137150000	137200000	0.4414513993	0.002112888620585572	50000
chr6	137200000	137400000	-0.047437489599999993	0.3797162692423785	200000
chr6	137400000	137650000	0.00993955959999998	0.8056142469061274	250000
chr6	137650000	137950000	-0.0253518794	0.5922124962269846	300000
chr6	137950000	138200000	-0.3518753104999999	0.005433142167220043	250000
chr6	138200000	138300000	-0.19203924489999996	0.024147298520977967	100000
chr6	138300000	138400000	-0.35802285139999995	0.005433142167220043	100000
chr6	138400000	138750000	0.0924821991	0.16872924841533354	350000
chr6	138750000	143000000	-0.2121217478458823	0.002112888620585572	4250000
chr6	143000000	143050000	0.11014240770000006	0.11439782674313312	50000
chr6	143050000	143300000	-0.03125103500000004	0.5089043163296106	250000
chr6	143300000	143500000	-0.23915797319999998	0.01056444310292786	200000
chr6	143500000	143850000	-0.10594351008571425	0.09749471777844854	350000
chr6	143850000	144500000	-0.22729756584615382	0.005433142167220043	650000
chr6	144500000	145600000	-0.08124087370454541	0.062481134923030486	1100000
chr6	145600000	145850000	-0.4235303858	0.002112888620585572	250000
chr6	145850000	146150000	-0.16696472920000002	0.043766978569272565	300000
chr6	146150000	146250000	-0.07270243410000005	0.24841533353456083	100000
chr6	146250000	146300000	0.017461500299999988	0.70691216420163	50000
chr6	146300000	147150000	-0.22021687464117648	0.006942348324781165	850000
chr6	147150000	147650000	0.06879036270000005	0.26139450648958645	500000
chr6	147650000	147700000	-0.10898741509999998	0.11439782674313312	50000
chr6	147700000	148450000	0.4744535519	0.0006036824630244491	750000
chr6	148450000	149350000	0.12521733730555554	0.03380621792936915	900000
chr6	149350000	149700000	-0.005625931499999903	0.8780561424690613	350000
chr6	149700000	149750000	0.14806259310000003	0.058859040144883794	50000
chr6	149750000	149850000	-0.06405861899999998	0.2816178690009055	100000
chr6	149850000	149900000	0.16826461329999998	0.04346513733776034	50000
chr6	149900000	150300000	0.22000641655	0.011771808028976758	400000
chr6	150300000	150400000	0.653920351	0.00030184123151222455	100000
chr6	150400000	150700000	0.007455704600000002	0.8412315122245698	300000
chr6	150700000	150750000	-0.04506954799999996	0.3878659824932086	50000
chr6	150750000	151800000	0.10282035812857143	0.03773015393902807	1050000
chr6	151800000	152350000	-0.22050422250000004	0.013281014186537881	550000
chr6	152350000	152700000	0.1592097793	0.028071234530636886	350000
chr6	152700000	152750000	0.47449080969999996	0.001509206157561123	50000
chr6	152750000	153050000	-0.13763040240000002	0.06610322970117719	300000
chr6	153050000	153250000	0.07753353209999997	0.22517355870811953	200000
chr6	153250000	153300000	-0.22369597609999997	0.012375490492001207	50000
chr6	153300000	153500000	0.32781917540000005	0.006640507093268941	200000
chr6	153500000	153550000	-0.13076668319999996	0.06851795955327497	50000
chr6	153550000	153700000	0.09259397250000001	0.16661635979474795	150000
chr6	153700000	153900000	0.33234807085	0.005734983398732267	200000
chr6	153900000	154050000	0.18083291935	0.03380621792936915	150000
chr6	154050000	154400000	0.31029971852000005	0.006942348324781165	350000
chr6	154400000	154600000	0.07362146049999996	0.24479323875641412	200000
chr6	154600000	154700000	0.30392449079999995	0.006942348324781165	100000
chr6	154700000	154850000	0.1072031793	0.11832176275279203	150000
chr6	154850000	155000000	-0.028150355999999932	0.5614246906127377	150000
chr6	155000000	155200000	-0.2965929788999999	0.006942348324781165	200000
chr6	155200000	155600000	-0.08245156479999993	0.21460911560519166	400000
chr6	155600000	155850000	0.09499503229999995	0.16480531240567461	250000
chr6	155850000	156500000	-0.15516832901538458	0.03773015393902807	650000
chr6	156500000	156650000	0.01821493620000003	0.6903108964684576	150000
chr6	156650000	157000000	-0.09544626590000005	0.16178690009055238	350000
chr6	157000000	157100000	0.35505878459999995	0.005433142167220043	100000
chr6	157100000	157550000	0.0670351051555555	0.14790220344099003	450000
chr6	157600000	157650000	0.019113263800000002	0.6788409296709931	50000
chr6	157700000	158550000	0.03899603556470587	0.026260187141563536	850000
chr6	158550000	159400000	-0.018591410682352955	0.6492604889827951	850000
chr6	159400000	159450000	0.4027115417	0.003018412315122246	50000
chr6	159450000	159600000	-0.05789451900000003	0.3099909447630546	150000
chr6	159600000	159650000	0.13267925149999998	0.06851795955327497	50000
chr6	159650000	159900000	0.003386322300000022	0.904618170842137	250000
chr6	159900000	160000000	0.1528812717	0.0516148505885904	100000
chr6	160000000	160050000	0.5144974334	0.0009055236945366737	50000
chr6	160050000	160250000	0.15179251532499993	0.047087232115907034	200000
chr6	160250000	160500000	0.010465308799999962	0.8056142469061274	250000
chr6	160500000	160550000	0.14980957109999993	0.05493510413522487	50000
chr6	160550000	160950000	-0.12291770160000004	0.08572290974947178	400000
chr6	160950000	161800000	0.1509158606352942	0.0018110473890733474	850000
chr6	161800000	161900000	-0.18925732739999998	0.026260187141563536	100000
chr6	161900000	162200000	0.03410332830000001	0.47721098702082704	300000
chr6	162200000	163550000	-0.061613708412962966	0.00724418955629339	1350000
chr6	163550000	163750000	0.42648617320000004	0.002112888620585572	200000
chr6	163750000	165150000	0.03426951007857143	0.3878659824932086	1400000
chr6	165150000	165200000	-0.009732571600000003	0.809236341684274	50000
chr6	165200000	165650000	0.006269893854444444	0.8025958345910051	450000
chr6	165650000	166000000	-0.04083102688714285	0.3048596438273468	350000
chr6	166000000	166700000	0.045737823178571425	0.3703591910654995	700000
chr6	166700000	166850000	0.38253435995	0.004527618472683369	150000
chr6	166850000	166900000	-0.279350886	0.00724418955629339	50000
chr6	166900000	167100000	-0.01672462330000002	0.7129489888318744	200000
chr6	167100000	167150000	-0.3298559365	0.005734983398732267	50000
chr6	167150000	167500000	0.11678021430000005	0.0516148505885904	350000
chr6	167500000	167550000	-0.05387481369999997	0.3308179897373981	50000
chr6	167550000	167950000	0.06726486174999999	0.26471476003622096	400000
chr6	168050000	168150000	0.221557791	0.013281014186537881	100000
chr6	168150000	168200000	-0.004876635199999979	0.8786598249320857	50000
chr6	168200000	168400000	0.259837100575	0.004829459704195593	200000
chr6	168400000	168700000	-0.1015772479	0.1388469664956233	300000
chr6	168700000	169250000	0.08551686759999999	0.0356172653184425	550000
chr6	169250000	170000000	-0.13713363140000007	0.012073649260488983	750000
chr6	170000000	170250000	0.09456284150000001	0.10624811349230305	250000
chr6	170350000	170450000	0.019692829899999986	0.6703893751886507	100000
chr6	170500000	170550000	0.019692829899999986	0.6703893751886507	50000
chr6	170600000	170950000	0.15772005772857142	0.016903108964684575	350000
chr7	0	200000	-0.029296480900000033	0.5055483028720626	200000
chr7	200000	600000	0.04062791209999994	0.3962140992167102	400000
chr7	600000	800000	-0.05066720470000008	0.32571801566579633	200000
chr7	800000	1000000	0.036875186150000044	0.09171018276762402	200000
chr7	1000000	1450000	-0.06056933091111104	0.04634464751958225	450000
chr7	1450000	1650000	0.10913407495000002	0.061031331592689295	200000
chr7	1650000	1900000	-0.03695324280000001	0.4200391644908616	250000
chr7	1900000	1950000	0.054341873900000004	0.2793733681462141	50000
chr7	1950000	2150000	-0.14022826180000003	0.04634464751958225	200000
chr7	2150000	5250000	0.08539728423225805	0.007180156657963447	3100000
chr7	5250000	5800000	-0.005533619699999992	0.8772845953002611	550000
chr7	5800000	6000000	-0.25865588765	0.00587467362924282	200000
chr7	6000000	6550000	0.07971281243636362	0.006201044386422976	550000
chr7	6550000	6800000	-0.16242758740000007	0.03426892950391645	250000
chr7	6850000	7000000	-0.16242758740000007	0.03426892950391645	150000
chr7	7000000	7300000	0.1255872266	0.020561357702349868	300000
chr7	7300000	7450000	-0.15389418880000005	0.03883812010443864	150000
chr7	7450000	7700000	0.07115888979999996	0.18635770234986945	250000
chr7	7700000	8150000	0.32854905800000006	0.0039164490861618795	450000
chr7	8150000	8350000	-0.21709850039999998	0.019255874673629242	200000
chr7	8350000	8450000	0.22634041367	0.019255874673629242	100000
chr7	8450000	9150000	-0.00295894938	0.9324412532637075	700000
chr7	9150000	9400000	0.089553371538	0.07114882506527415	250000
chr7	9400000	10950000	-0.03990986794690321	0.1106396866840731	1550000
chr7	10950000	11200000	0.1467994351	0.04340731070496084	250000
chr7	11200000	12650000	-0.1872699915517242	0.00587467362924282	1450000
chr7	12650000	12800000	0.011110470599999922	0.7672976501305483	150000
chr7	12800000	13300000	-0.2712674487000001	0.007180156657963447	500000
chr7	13300000	13800000	-0.05800693619999999	0.12695822454308095	500000
chr7	13800000	14100000	0.03415521031666666	0.03720626631853786	300000
chr7	14100000	15850000	-0.21579057888571426	0.009138381201044387	1750000
chr7	15850000	15950000	0.007219644400000003	0.8407310704960835	100000
chr7	15950000	16850000	-0.03457231333333334	0.18635770234986945	900000
chr7	16850000	17050000	0.08346302755000004	0.08779373368146214	200000
chr7	17050000	17700000	-0.01399773718461533	0.5434073107049608	650000
chr7	17700000	17750000	0.0774466573	0.16383812010443866	50000
chr7	17750000	18400000	-0.22975569448461539	0.006201044386422976	650000
chr7	18400000	19750000	0.05522180203333334	0.19255874673629242	1350000
chr7	19750000	19950000	-0.1212833002	0.0639686684073107	200000
chr7	19950000	20200000	0.09952349380000003	0.10672323759791123	250000
chr7	20200000	20250000	-0.14482039759999998	0.04406005221932115	50000
chr7	20250000	20650000	0.07125736134999999	0.019255874673629242	400000
chr7	20650000	20700000	-0.15323611069999998	0.03883812010443864	50000
chr7	20700000	20850000	0.1657684142	0.031657963446475194	150000
chr7	20850000	21100000	0.37444351577	0.0009791122715404699	250000
chr7	21100000	21400000	0.08660931300499997	0.04046997389033943	300000
chr7	21400000	21450000	-0.06836806260000003	0.19255874673629242	50000
chr7	21450000	22150000	0.16057824404285714	0.007180156657963447	700000
chr7	22150000	22400000	-0.0941205291	0.11422976501305483	250000
chr7	22400000	22600000	0.20014698679999998	0.021866840731070498	200000
chr7	22600000	23150000	-0.011345841600000073	0.7594647519582245	550000
chr7	23150000	23750000	0.09071189314999996	0.027088772845953003	600000
chr7	23750000	23800000	-0.15827977439999996	0.03524804177545692	50000
chr7	23800000	24150000	0.17139055524285712	0.019255874673629242	350000
chr7	24150000	24750000	0.05936272112500001	0.07539164490861619	600000
chr7	24750000	24800000	0.4720196751	0.0006527415143603133	50000
chr7	24800000	25150000	0.04668030859999994	0.3495430809399478	350000
chr7	25150000	25200000	0.6530151501999999	0.00032637075718015666	50000
chr7	25200000	26100000	-0.04454275584444446	0.03883812010443864	900000
chr7	26100000	26300000	0.08685669269999996	0.13805483028720628	200000
chr7	26300000	26450000	-0.04839035069999997	0.33779373368146215	150000
chr7	26450000	27100000	0.07174491551538463	0.13936031331592688	650000
chr7	27100000	27150000	-0.03586285080000001	0.42428198433420367	50000
chr7	27150000	27600000	0.19994684138888885	0.015339425587467363	450000
chr7	27600000	27650000	-0.1042020924	0.09432114882506527	50000
chr7	27650000	30250000	0.14337824224423074	0.0039164490861618795	2600000
chr7	30250000	30650000	-0.05402964714999997	0.18113577023498695	400000
chr7	30650000	31750000	0.09475144557545455	0.029699738903394255	1100000
chr7	31750000	32250000	-0.23535656299999994	0.009138381201044387	500000
chr7	32250000	32500000	-0.011182523	0.7650130548302873	250000
chr7	32500000	32900000	0.1723684084	0.0293733681462141	400000
chr7	32900000	33150000	0.045392973500000044	0.3599869451697128	250000
chr7	33150000	33200000	0.5114563219000001	0.0006527415143603133	50000
chr7	33200000	33750000	0.057875931954545455	0.11259791122715404	550000
chr7	33750000	34400000	-0.043297543623076945	0.19647519582245432	650000
chr7	34400000	34700000	0.0309424766	0.05939947780678851	300000
chr7	34700000	34850000	-0.109303398	0.08159268929503917	150000
chr7	34850000	35250000	0.21766050860000008	0.019255874673629242	400000
chr7	35250000	35600000	-0.011321824099999989	0.7633812010443864	350000
chr7	35600000	36050000	0.20174975109999999	0.005221932114882507	450000
chr7	36050000	37000000	-0.05955037315789476	0.01664490861618799	950000
chr7	37000000	37600000	0.08160647896083334	0.13054830287206268	600000
chr7	37600000	38150000	-0.05986501323272728	0.061031331592689295	550000
chr7	38150000	39300000	0.07543629256173913	0.009138381201044387	1150000
chr7	39300000	39600000	-0.0411130646	0.39099216710182766	300000
chr7	39600000	40200000	0.10394350456666666	0.0489556135770235	600000
chr7	40200000	42000000	-0.33049860750277776	0.0006527415143603133	1800000
chr7	42000000	42300000	0.20321161290000003	0.02154046997389034	300000
chr7	42300000	42350000	-0.219293695	0.019255874673629242	50000
chr7	42350000	42600000	0.049937074299999995	0.3322454308093995	250000
chr7	42600000	42750000	0.29834471760000003	0.00587467362924282	150000
chr7	42750000	42900000	0.02658250959999997	0.54177545691906	150000
chr7	42900000	43000000	-0.12336801459999996	0.0639686684073107	100000
chr7	43000000	43750000	0.07280456521333332	0.005221932114882507	750000
chr7	43750000	44900000	-0.07238127337391298	0.04046997389033943	1150000
chr7	44900000	45200000	0.037596910400000016	0.4148172323759791	300000
chr7	45200000	45250000	0.46293627690000005	0.0006527415143603133	50000
chr7	45250000	46400000	-0.08843328139565218	0.009138381201044387	1150000
chr7	46400000	47000000	0.026837094499999936	0.5391644908616188	600000
chr7	47000000	47100000	-0.12178286299999996	0.0639686684073107	100000
chr7	47100000	47600000	0.020984523120000008	0.32930809399477806	500000
chr7	47600000	47900000	-0.009919205300000011	0.7927545691906005	300000
chr7	47900000	48350000	0.14889695869999997	0.020234986945169713	450000
chr7	48350000	48700000	0.3713961821000001	0.00293733681462141	350000
chr7	48700000	48750000	-0.019261992000000006	0.6377284595300261	50000
chr7	48750000	49300000	0.20339414546818183	0.00293733681462141	550000
chr7	49300000	49750000	0.04026551553444445	0.19941253263707573	450000
chr7	49750000	50100000	-0.02782455462714287	0.2947127937336815	350000
chr7	50100000	50400000	0.02477639749999999	0.5571148825065274	300000
chr7	50400000	50700000	-0.05163270600000003	0.30613577023498695	300000
chr7	50700000	50800000	0.39847345109999993	0.0009791122715404699	100000
chr7	50800000	51200000	0.08003453704999998	0.0714751958224543	400000
chr7	51200000	51500000	-0.0024449759999999876	0.943864229765013	300000
chr7	51500000	51550000	0.0993649787	0.10672323759791123	50000
chr7	51550000	51700000	-0.05562440558000001	0.27513054830287204	150000
chr7	51700000	51750000	0.01903622791000001	0.6432767624020888	50000
chr7	51750000	52050000	-0.03404232834999999	0.4510443864229765	300000
chr7	52050000	52300000	0.00810828986	0.8325718015665796	250000
chr7	52300000	52500000	-0.00038427913999999896	0.9843342036553525	200000
chr7	52500000	53300000	0.0554094494175	0.09660574412532637	800000
chr7	53300000	53750000	-0.052454102658	0.29928198433420367	450000
chr7	53750000	54050000	0.030872025440000003	0.4849869451697128	300000
chr7	54050000	55050000	-0.03902474757674999	0.0639686684073107	1000000
chr7	55050000	55250000	0.041386863375000055	0.0639686684073107	200000
chr7	55250000	55300000	-0.20656925189999997	0.020561357702349868	50000
chr7	55300000	56500000	0.13271660535000002	0.025456919060052218	1200000
chr7	56500000	56900000	-0.06227453620500001	0.025130548302872063	400000
chr7	56900000	56950000	0.0956014449	0.11422976501305483	50000
chr7	57050000	57100000	0.0956014449	0.11422976501305483	50000
chr7	57100000	57150000	-0.12202063579999997	0.0639686684073107	50000
chr7	57150000	57500000	0.017119635700000024	0.6883159268929504	350000
chr7	57500000	58050000	-0.09413638068999998	0.11684073107049608	550000
chr7	61050000	61100000	0.1011927064	0.10280678851174935	50000
chr7	61500000	61600000	0.003907638599999985	0.9024151436031331	100000
chr7	61650000	61950000	0.020352784316666674	0.13936031331592688	300000
chr7	61950000	62200000	-0.0816256929	0.1556788511749347	250000
chr7	62200000	62750000	0.06421129760636363	0.13936031331592688	550000
chr7	62800000	62850000	0.08582874597000001	0.13936031331592688	50000
chr7	62900000	63050000	0.05082091632333333	0.13936031331592688	150000
chr7	63100000	63150000	0.0333170015	0.4595300261096606	50000
chr7	63200000	63550000	0.033189365900000004	0.4595300261096606	350000
chr7	63550000	64000000	-0.019910462959999996	0.6354438642297651	450000
chr7	64000000	64150000	0.05007637549999999	0.3306135770234987	150000
chr7	64150000	64450000	-0.09854358210000001	0.10868146214099217	300000
chr7	64450000	64600000	0.22205089780000006	0.019255874673629242	150000
chr7	64600000	64650000	-0.004063751899999968	0.9014360313315927	50000
chr7	64650000	65000000	0.042316338600000024	0.3857702349869452	350000
chr7	65050000	65100000	0.04231633860000003	0.3857702349869452	50000
chr7	65150000	65900000	0.051733579226666625	0.19255874673629242	750000
chr7	65900000	66250000	-0.03753858225714287	0.07114882506527415	350000
chr7	66250000	67300000	0.09171759509047614	0.07702349869451697	1050000
chr7	67300000	67850000	-0.020049764150000007	0.633485639686684	550000
chr7	67850000	68050000	0.10946191314	0.08159268929503917	200000
chr7	68050000	69800000	-0.11777743926228568	0.00293733681462141	1750000
chr7	69800000	70450000	0.0561720033476923	0.25	650000
chr7	70450000	70950000	-0.043197778869999995	0.27904699738903394	500000
chr7	70950000	72400000	0.061902731664827584	0.00881201044386423	1450000
chr7	72400000	72450000	-0.07990844549999998	0.15861618798955612	50000
chr7	72650000	72850000	-0.07990844549999998	0.15861618798955612	200000
chr7	72850000	74150000	0.024826741838461522	0.04046997389033943	1300000
chr7	74450000	74500000	0.1668996359	0.031657963446475194	50000
chr7	75050000	76250000	0.11213245301666667	0.007180156657963447	1200000
chr7	76250000	76300000	-0.22340548170000002	0.019255874673629242	50000
chr7	76300000	77550000	0.0445143192	0.13936031331592688	1250000
chr7	77550000	83600000	-0.18171976984628097	0.00293733681462141	6050000
chr7	83600000	83650000	0.23602905149999998	0.015339425587467363	50000
chr7	83650000	85500000	-0.1572149577054054	0.009138381201044387	1850000
chr7	85500000	86050000	0.08909817542636365	0.12173629242819843	550000
chr7	86050000	86250000	-0.06926631505	0.19255874673629242	200000
chr7	86250000	86950000	0.09170958928357142	0.04634464751958225	700000
chr7	86950000	87050000	-0.09764052599999998	0.1106396866840731	100000
chr7	87050000	87400000	0.0991920532	0.10672323759791123	350000
chr7	87400000	87450000	-0.2085002545	0.020234986945169713	50000
chr7	87450000	88000000	0.029291677500000002	0.5055483028720626	550000
chr7	88000000	88100000	0.43879393991000004	0.0009791122715404699	100000
chr7	88100000	88500000	0.17552430081	0.028067885117493474	400000
chr7	88500000	88600000	0.007796063060000002	0.83322454308094	100000
chr7	88600000	88950000	-0.06912701386999999	0.19255874673629242	350000
chr7	88950000	90750000	0.07647408411188888	0.019255874673629242	1800000
chr7	90750000	90900000	-0.10712261379999999	0.08779373368146214	150000
chr7	90900000	90950000	0.18925747670000004	0.025130548302872063	50000
chr7	90950000	92150000	-0.12673085730000003	0.027088772845953003	1200000
chr7	92150000	92450000	0.016533609999999976	0.6981070496083551	300000
chr7	92450000	93200000	-0.06076029626000001	0.17101827676240208	750000
chr7	93200000	93250000	0.038965904800000006	0.40763707571801566	50000
chr7	93250000	93900000	-0.15193842960000004	0.015339425587467363	650000
chr7	93900000	96850000	0.11576661489322031	0.00587467362924282	2950000
chr7	96850000	97450000	-0.00013930118799999978	0.9908616187989556	600000
chr7	97450000	97500000	-0.382492242349	0.0022845953002610967	50000
chr7	97500000	98450000	0.1621392516	0.00032637075718015666	950000
chr7	98450000	99200000	-0.016843595233333328	0.2568537859007833	750000
chr7	99200000	100900000	0.044410659894117646	0.0009791122715404699	1700000
chr7	100900000	101950000	-0.11032837115714286	0.006201044386422976	1050000
chr7	101950000	102150000	0.19760113750000008	0.023825065274151437	200000
chr7	102300000	102800000	0.034320930699999974	0.4435378590078329	500000
chr7	102800000	103650000	-0.2751495157	0.0032637075718015664	850000
chr7	103650000	104500000	-0.10284553050588233	0.03720626631853786	850000
chr7	104500000	104550000	0.6301793623	0.00032637075718015666	50000
chr7	104550000	105350000	-0.0645889174	0.13936031331592688	800000
chr7	105350000	105550000	0.04888270840000003	0.19255874673629242	200000
chr7	105550000	106800000	-0.09514693871999999	0.044386422976501305	1250000
chr7	106800000	107350000	0.12319945576363639	0.028067885117493474	550000
chr7	107350000	107400000	-0.2703307682	0.007180156657963447	50000
chr7	107400000	107750000	-0.07762575875714285	0.13185378590078328	350000
chr7	107750000	107800000	-0.6081217396999999	0.00032637075718015666	50000
chr7	107800000	108100000	-0.11038418309999998	0.07996083550913838	300000
chr7	108100000	109300000	0.03574196295791668	0.19027415143603132	1200000
chr7	109300000	109650000	0.0	0.9951044386422977	350000
chr7	109650000	110500000	-0.009049773756	0.8159268929503917	850000
chr7	110500000	110700000	-0.2647058824	0.007506527415143603	200000
chr7	110700000	111100000	0.03127551849999999	0.4813968668407311	400000
chr7	111100000	111350000	-0.02761525974000002	0.42297650130548303	250000
chr7	111350000	111400000	0.5500187336	0.0006527415143603133	50000
chr7	111400000	112150000	0.11964531031333327	0.0489556135770235	750000
chr7	112150000	112200000	-0.43349569130000004	0.0009791122715404699	50000
chr7	112200000	112400000	-0.10317894919999998	0.09660574412532637	200000
chr7	112400000	112650000	0.03461106153999995	0.168733681462141	250000
chr7	112650000	113700000	-0.20733071932857144	0.0039164490861618795	1050000
chr7	113700000	113950000	0.01828688360000008	0.6622062663185379	250000
chr7	113950000	114450000	-0.024699541800000002	0.5571148825065274	500000
chr7	114450000	114500000	-0.23736922500000002	0.015339425587467363	50000
chr7	114500000	115000000	-0.05855453400000003	0.22943864229765012	500000
chr7	115000000	115800000	-0.3402503579	0.0035900783289817234	800000
chr7	115800000	116200000	-0.006230125599999914	0.8554177545691906	400000
chr7	116200000	116450000	0.011869422000000074	0.7509791122715405	250000
chr7	116450000	116850000	-0.09543572450000004	0.11422976501305483	400000
chr7	116850000	118500000	0.07902962529575756	0.006201044386422976	1650000
chr7	118500000	120600000	-0.049807951903571436	0.038511749347258484	2100000
chr7	120600000	120750000	0.1278544735	0.05939947780678851	150000
chr7	120750000	121550000	-0.07304666108124999	0.07408616187989556	800000
chr7	121550000	121800000	0.09051695159999995	0.12695822454308095	250000
chr7	121800000	121850000	-0.005024449700000044	0.8857702349869452	50000
chr7	121850000	122000000	0.14882170409999998	0.041449086161879894	150000
chr7	122000000	122250000	0.38024420940000003	0.00293733681462141	250000
chr7	122250000	122450000	0.6868845529000001	0.00032637075718015666	200000
chr7	122450000	122800000	0.43249725167714287	0.0006527415143603133	350000
chr7	122800000	123450000	0.10507891393615387	0.031331592689295036	650000
chr7	123450000	123500000	-0.24274913299999998	0.01468668407310705	50000
chr7	123500000	124000000	0.06583182022	0.11422976501305483	500000
chr7	124000000	124600000	-0.06510409162500001	0.04634464751958225	600000
chr7	124600000	126550000	-0.3147861991533333	0.0009791122715404699	1950000
chr7	126550000	126850000	-0.03682835213000001	0.4200391644908616	300000
chr7	126850000	127200000	0.03173184999999995	0.4781331592689295	350000
chr7	127200000	128550000	-0.1176111216	0.006201044386422976	1350000
chr7	128550000	128600000	0.13355621519999994	0.0564621409921671	50000
chr7	128600000	130200000	-0.09123664931562503	0.013381201044386422	1600000
chr7	130250000	130500000	-0.10545340130000003	0.09432114882506527	250000
chr7	130500000	130550000	0.1249075329	0.061031331592689295	50000
chr7	130550000	131200000	-0.06132910329230766	0.17101827676240208	650000
chr7	131200000	132250000	0.10836511641904763	0.009138381201044387	1050000
chr7	132250000	132500000	-0.05115235705999999	0.13936031331592688	250000
chr7	132500000	132800000	0.05900366026666671	0.033942558746736295	300000
chr7	132800000	132950000	-0.019891249	0.6354438642297651	150000
chr7	132950000	133650000	0.07471141325714285	0.0564621409921671	700000
chr7	133650000	133800000	-0.0279995388	0.5257832898172323	150000
chr7	133800000	134100000	0.04690447133333334	0.168733681462141	300000
chr7	134100000	134250000	-0.3880114516	0.0022845953002610967	150000
chr7	134250000	135050000	-0.06788050840000004	0.13936031331592688	800000
chr7	135050000	135250000	0.03457071210000007	0.4402741514360313	200000
chr7	135250000	135800000	-0.038889049045454545	0.25130548302872063	550000
chr7	135800000	136300000	0.11402042446	0.025783289817232376	500000
chr7	136300000	137100000	-0.08223423496250001	0.04308093994778068	800000
chr7	137100000	137250000	0.21442295689999993	0.0195822454308094	150000
chr7	137250000	137350000	-0.19281686210000004	0.024804177545691905	100000
chr7	137350000	137700000	0.09614801335714289	0.05678851174934726	350000
chr7	137700000	138500000	-0.15814257475	0.02447780678851175	800000
chr7	138500000	138800000	0.0512099989	0.31429503916449086	300000
chr7	138800000	140200000	-0.08963362417499998	0.006201044386422976	1400000
chr7	140200000	140650000	0.15914333507777784	0.020234986945169713	450000
chr7	140650000	140700000	-0.06900212309999998	0.19255874673629242	50000
chr7	140700000	142050000	0.10234136300222225	0.03883812010443864	1350000
chr7	142100000	142400000	0.09562306060000003	0.11422976501305483	300000
chr7	142400000	142950000	-0.007901303154545437	0.6377284595300261	550000
chr7	142950000	143100000	0.0023441028000000808	0.9513707571801566	150000
chr7	143100000	143150000	-0.23332468699999998	0.01664490861618799	50000
chr7	143150000	143250000	0.07436762069999997	0.17265013054830286	100000
chr7	143400000	143450000	0.07436762069999997	0.17265013054830286	50000
chr7	143500000	143600000	0.07436762069999997	0.17265013054830286	100000
chr7	143600000	143900000	-0.08853671306333333	0.10868146214099217	300000
chr7	144050000	144400000	-0.02090169728571429	0.5055483028720626	350000
chr7	144400000	145250000	0.052228338655294124	0.1746083550913838	850000
chr7	145250000	148150000	-0.08796149522672415	0.006201044386422976	2900000
chr7	148150000	149950000	0.10927631165499999	0.00587467362924282	1800000
chr7	149950000	150000000	-0.06429950720000005	0.20822454308093996	50000
chr7	150000000	151150000	0.0673048206391305	0.05319843342036554	1150000
chr7	151150000	151450000	-0.06435234556666662	0.03426892950391645	300000
chr7	151450000	153400000	0.09586323504076924	0.01664490861618799	1950000
chr7	153400000	153650000	-0.09593048392999999	0.11422976501305483	250000
chr7	153650000	153850000	0.07820921117500002	0.0662532637075718	200000
chr7	153850000	154300000	-0.001743666599999999	0.9595300261096605	450000
chr7	154350000	154950000	0.105155585	0.038511749347258484	600000
chr7	154950000	155100000	-0.02605892919999997	0.543733681462141	150000
chr7	155100000	157600000	0.13704383665800002	0.00032637075718015666	2500000
chr7	157600000	157700000	-0.030814383500000042	0.4849869451697128	100000
chr7	157700000	159138663	0.11694492123793108	0.0006527415143603133	1438663
chr8	150000	350000	0.03673407019999997	0.4538024164889837	200000
chr8	350000	550000	-0.03960180760000004	0.4090262970859986	200000
chr8	550000	2450000	0.06994702793684211	0.0216773276474769	1900000
chr8	2450000	3300000	-0.061790476106470586	0.09346126510305615	850000
chr8	3300000	5100000	0.03776735676583334	0.23312011371712865	1800000
chr8	5100000	5450000	-0.08815941794000001	0.16631130063965885	350000
chr8	5450000	5700000	0.018076147900000006	0.6538734896943852	250000
chr8	5700000	5800000	0.2397851548	0.018834399431414357	100000
chr8	5800000	6300000	-0.2438728558	0.0014214641080312722	500000
chr8	6300000	7000000	0.05917058925714288	0.21570717839374556	700000
chr8	7200000	7250000	0.077716858	0.21570717839374556	50000
chr8	8050000	8250000	0.03849702349999995	0.4271499644633973	200000
chr8	8250000	8500000	-0.08390482399999999	0.19047619047619047	250000
chr8	8500000	10450000	0.13484242133846153	0.021321961620469083	1950000
chr8	10450000	10650000	-0.07674135709999996	0.21641791044776118	200000
chr8	10650000	11250000	0.12875582505	0.008528784648187633	600000
chr8	11250000	11400000	-0.035529385499999955	0.4662402274342573	150000
chr8	11400000	11450000	-0.3242129883	0.006396588486140725	50000
chr8	11450000	11800000	0.1339475126285714	0.055792466240227434	350000
chr8	11800000	11850000	-0.3420952113	0.005330490405117271	50000
chr8	11850000	11900000	0.0701185292	0.2459132906894101	50000
chr8	12200000	12250000	0.0701185292	0.2459132906894101	50000
chr8	12400000	13150000	0.03014062493333336	0.2459132906894101	750000
chr8	13150000	13250000	-0.12125592789999995	0.08599857853589196	100000
chr8	13250000	15200000	0.02837269917692307	0.10589907604832978	1950000
chr8	15200000	15250000	-0.27657799010999995	0.013859275053304905	50000
chr8	15250000	15650000	0.24305249489999997	0.01847903340440654	400000
chr8	15650000	15950000	-0.10309652953333337	0.04584221748400853	300000
chr8	15950000	16050000	0.1352949127	0.055792466240227434	100000
chr8	16050000	16250000	-0.007198725999999989	0.8528784648187633	200000
chr8	16250000	16700000	0.14335552690000006	0.02736318407960199	450000
chr8	16700000	16900000	-0.13662300419999995	0.0511727078891258	200000
chr8	16900000	18750000	0.07623359479999998	0.0433546552949538	1850000
chr8	18750000	18800000	-0.07734663780000006	0.21641791044776118	50000
chr8	18800000	19150000	0.0034847709999999976	0.9243070362473348	350000
chr8	19150000	19200000	-0.19512954770000002	0.031982942430703626	50000
chr8	19200000	19700000	0.1848021673	0.024164889836531627	500000
chr8	19700000	19750000	-0.2973867155	0.008528784648187633	50000
chr8	19750000	21300000	0.10130915395161294	0.005330490405117271	1550000
chr8	21300000	21450000	-0.02139049999999998	0.6094527363184079	150000
chr8	21450000	21750000	0.2234131952	0.024164889836531627	300000
chr8	21750000	22300000	0.00481873901818175	0.8088130774697939	550000
chr8	22300000	23300000	-0.06302793107999997	0.03375977256574272	1000000
chr8	23300000	25900000	0.10404769558461537	0.0014214641080312722	2600000
chr8	25900000	26100000	-0.03664004600000004	0.4538024164889837	200000
chr8	26100000	26200000	0.365207529	0.005330490405117271	100000
chr8	26200000	26550000	0.02932966640000001	0.511727078891258	350000
chr8	26550000	27900000	-0.03421370000370368	0.015636105188343994	1350000
chr8	27900000	28050000	0.09183223740000002	0.14925373134328357	150000
chr8	28050000	28200000	-0.08137792429999996	0.20398009950248755	150000
chr8	28200000	28550000	0.013518493785714276	0.5358919687277897	350000
chr8	28550000	28650000	-0.10567142080000003	0.11975835110163469	100000
chr8	28650000	28900000	0.07908608499999992	0.20753375977256575	250000
chr8	28900000	29100000	-0.019098660699999992	0.6442786069651741	200000
chr8	29100000	30050000	0.033180018263157834	0.20398009950248755	950000
chr8	30050000	30450000	-0.08856636641250001	0.04584221748400853	400000
chr8	30450000	30850000	0.07590983081250001	0.19047619047619047	400000
chr8	30850000	31750000	0.38487751721222224	0.0014214641080312722	900000
chr8	31750000	32400000	0.11126902352307694	0.02736318407960199	650000
chr8	32400000	32950000	-0.0585904173636364	0.205046197583511	550000
chr8	32950000	33450000	0.029655225079999993	0.2302771855010661	500000
chr8	33450000	33500000	-0.374568811	0.005330490405117271	50000
chr8	33500000	34000000	0.09120815188000002	0.02025586353944563	500000
chr8	34000000	34750000	-0.08381079987400002	0.024520255863539446	750000
chr8	34750000	36050000	0.13380273095769232	0.006396588486140725	1300000
chr8	36050000	37250000	-0.05212171430833334	0.06325515280739161	1200000
chr8	37250000	37600000	0.09840301621428571	0.06858564321250889	350000
chr8	37600000	38600000	-0.05142387859500003	0.0433546552949538	1000000
chr8	38600000	38650000	0.20935658079999997	0.02523098791755508	50000
chr8	38650000	38900000	0.043962178699999965	0.3763326226012793	250000
chr8	38900000	38950000	0.41546345099999993	0.004619758351101635	50000
chr8	38950000	39150000	0.08982834709999998	0.15707178393745558	200000
chr8	39150000	39200000	-0.2542825074	0.015636105188343994	50000
chr8	39200000	39700000	0.1133872797	0.03802416488983653	500000
chr8	39700000	39850000	0.4574981342	0.0028429282160625444	150000
chr8	39850000	40100000	0.23866861770000006	0.018834399431414357	250000
chr8	40100000	40300000	-0.11929904969999999	0.09168443496801706	200000
chr8	40300000	40600000	0.0511844108	0.33972992181947403	300000
chr8	40600000	40650000	-0.10403187419999999	0.12082444918265814	50000
chr8	40650000	41200000	0.02367218897272727	0.3763326226012793	550000
chr8	41200000	41700000	-0.058976664400000024	0.2420042643923241	500000
chr8	41700000	42000000	-0.1590771527	0.04299928926794598	300000
chr8	42000000	42450000	-0.052855298699999956	0.2302771855010661	450000
chr8	42450000	42700000	-0.34942792157999997	0.004619758351101635	250000
chr8	42700000	42950000	-0.01181178709999997	0.7711442786069652	250000
chr8	42950000	43800000	0.12938521671647057	0.006041222459132907	850000
chr8	46900000	47350000	0.0354647439	0.4410092395167022	450000
chr8	47350000	47400000	0.14192949365000002	0.04797441364605544	50000
chr8	47400000	48150000	0.043455623554	0.228500355366027	750000
chr8	48150000	48700000	0.28336055223636364	0.005330490405117271	550000
chr8	48700000	48900000	0.11533240479999995	0.10163468372423597	200000
chr8	48900000	49000000	0.24255886790000003	0.01847903340440654	100000
chr8	49000000	49850000	-0.19859980030588237	0.014214641080312722	850000
chr8	49850000	50450000	-0.015681469595	0.36673773987206826	600000
chr8	50450000	51150000	0.18230196365000007	0.012437810945273632	700000
chr8	51150000	51950000	-0.047900910269375	0.06112295664534471	800000
chr8	51950000	52200000	0.009778514299999999	0.8031272210376688	250000
chr8	52200000	52700000	-0.023000076393000002	0.22316986496090974	500000
chr8	52700000	52900000	0.15830732979999995	0.04299928926794598	200000
chr8	52900000	53300000	-0.07090010521000001	0.24378109452736318	400000
chr8	53300000	55600000	0.12076357848913045	0.0014214641080312722	2300000
chr8	55600000	55900000	-0.03233843999999997	0.4914712153518124	300000
chr8	55900000	56650000	0.04123391064000001	0.31520966595593464	750000
chr8	56650000	56950000	-0.08949338595000006	0.04015636105188344	300000
chr8	56950000	57500000	0.08138540352727273	0.1908315565031983	550000
chr8	57500000	58000000	0.36283576911399995	0.0014214641080312722	500000
chr8	58000000	58350000	0.13226263304	0.06112295664534471	350000
chr8	58350000	58500000	-0.038638059816	0.4250177683013504	150000
chr8	58500000	59300000	0.025313438403375	0.322316986496091	800000
chr8	59300000	59450000	-0.17708865890000003	0.03731343283582089	150000
chr8	59450000	59800000	0.20397369679999994	0.02736318407960199	350000
chr8	59800000	60500000	-0.0465205598385714	0.01457000710732054	700000
chr8	60500000	60700000	0.13934382876	0.04904051172707889	200000
chr8	60700000	60850000	-0.07481386152	0.228500355366027	150000
chr8	60850000	61300000	0.021878250449999997	0.5973702914001422	450000
chr8	61300000	61400000	-0.7185797648200001	0.0014214641080312722	100000
chr8	61400000	62000000	-0.07731725523333337	0.2082444918265814	600000
chr8	62000000	64200000	0.04807934250627274	0.08742004264392324	2200000
chr8	64200000	64800000	-0.023841005120999997	0.5600568585643213	600000
chr8	64800000	64950000	0.0023799869799999984	0.9587775408670931	150000
chr8	64950000	65100000	-0.08747186620666668	0.12011371712864251	150000
chr8	65100000	65450000	0.04883296689428572	0.29850746268656714	350000
chr8	65450000	66100000	-0.012370507686769235	0.6986496090973703	650000
chr8	66100000	66750000	0.049502824556307716	0.1453447050461976	650000
chr8	66750000	67350000	-0.09830815249999998	0.03802416488983653	600000
chr8	67350000	68450000	0.10084627102272727	0.024875621890547265	1100000
chr8	68450000	68750000	-0.0716464221	0.03802416488983653	300000
chr8	68750000	69400000	0.0	1.0	650000
chr8	69400000	70450000	-0.08504710583904761	0.03980099502487562	1050000
chr8	70450000	70800000	0.018628539859999998	0.650319829424307	350000
chr8	70800000	71000000	0.14795879392	0.04584221748400853	200000
chr8	71000000	71050000	0.53594955602	0.0014214641080312722	50000
chr8	71050000	71300000	0.12373581560000002	0.0824449182658138	250000
chr8	71300000	71600000	0.23550117829999992	0.018834399431414357	300000
chr8	71600000	72100000	0.09002814847999999	0.15280739161336176	500000
chr8	72100000	72300000	0.40849978552	0.004619758351101635	200000
chr8	72300000	72900000	0.10078999894666667	0.08528784648187633	600000
chr8	72900000	73050000	0.203873796	0.02736318407960199	150000
chr8	73050000	73100000	-0.29035253193000005	0.010660980810234541	50000
chr8	73100000	73850000	0.004812862510000002	0.8980099502487562	750000
chr8	73850000	74200000	0.10699951220000001	0.11940298507462686	350000
chr8	74200000	74500000	0.05274168620000008	0.3312011371712864	300000
chr8	74500000	74900000	0.3199172587000001	0.008173418621179816	400000
chr8	74900000	75000000	-0.3659949815	0.005330490405117271	100000
chr8	75000000	76300000	0.02690266734384616	0.30632551528073915	1300000
chr8	76300000	79400000	-0.18154855163596764	0.008528784648187633	3100000
chr8	79400000	79750000	0.017159412099999938	0.6599147121535182	350000
chr8	79750000	80000000	-0.06980119770000004	0.2498223169864961	250000
chr8	80000000	80150000	-0.2845817981	0.012437810945273632	150000
chr8	80150000	80200000	0.004101804699999989	0.9068941009239516	50000
chr8	80200000	80650000	-0.10501129264444442	0.005330490405117271	450000
chr8	80650000	82300000	0.10356602713636366	0.031982942430703626	1650000
chr8	82300000	83200000	-0.14159257368333333	0.01279317697228145	900000
chr8	83200000	83850000	0.06705777108461536	0.015636105188343994	650000
chr8	83850000	85050000	-0.18741883066916667	0.014925373134328358	1200000
chr8	85050000	85200000	0.05353501520000001	0.32551528073916136	150000
chr8	85200000	85700000	-0.06489313562000001	0.01847903340440654	500000
chr8	85700000	85850000	0.04322173839999999	0.378820184790334	150000
chr8	85850000	86000000	-0.07546027779999998	0.22316986496090974	150000
chr8	86000000	86600000	0.10908322509666668	0.03980099502487562	600000
chr8	86800000	86950000	0.07346814047000001	0.2302771855010661	150000
chr8	86950000	87000000	-0.06011964579999998	0.29850746268656714	50000
chr8	87000000	88550000	0.15611008336387105	0.017057569296375266	1550000
chr8	88550000	88850000	-0.16439539519999993	0.042643923240938165	300000
chr8	88850000	88900000	0.32059305750000006	0.008173418621179816	50000
chr8	88900000	89100000	0.03815030940000008	0.43283582089552236	200000
chr8	89100000	89150000	-0.09162068289999992	0.14925373134328357	50000
chr8	89150000	89650000	0.031035029880000054	0.4594882729211087	500000
chr8	89650000	90700000	-0.15402167423809526	0.012437810945273632	1050000
chr8	90700000	90750000	0.1305584448	0.06325515280739161	50000
chr8	90750000	91000000	-0.004301606099999966	0.9051172707889126	250000
chr8	91000000	92700000	0.08942304071911762	0.004975124378109453	1700000
chr8	92700000	92750000	-0.025997684659999992	0.5358919687277897	50000
chr8	92750000	93250000	0.07735075130300001	0.04299928926794598	500000
chr8	93250000	93500000	-0.032182124827999994	0.48329779673063256	250000
chr8	93500000	93750000	0.15922994204000002	0.04299928926794598	250000
chr8	93750000	93950000	0.43440344602	0.0017768301350390902	200000
chr8	93950000	94150000	0.711345779775	0.00035536602700781805	200000
chr8	94150000	94650000	0.17038943635	0.04015636105188344	500000
chr8	94650000	94700000	0.95791830475	0.00035536602700781805	50000
chr8	94700000	95200000	0.07191321569999998	0.10589907604832978	500000
chr8	95200000	95450000	-0.05981112887999995	0.055792466240227434	250000
chr8	95450000	95600000	0.06499421170000008	0.27114427860696516	150000
chr8	95600000	95750000	-0.32761548809999996	0.006396588486140725	150000
chr8	95750000	95800000	0.11811199459999999	0.09523809523809523	50000
chr8	95800000	96300000	-0.047027954570000016	0.36673773987206826	500000
chr8	96300000	97150000	-0.47556287464117647	0.0014214641080312722	850000
chr8	97150000	97250000	-0.09607507830000006	0.13539445628997868	100000
chr8	97250000	97450000	-0.2945483608	0.010305614783226724	200000
chr8	97450000	98150000	-0.15501816259999998	0.03731343283582089	700000
chr8	98150000	98200000	-0.28460530409999996	0.012437810945273632	50000
chr8	98200000	98600000	-0.009796143799999935	0.8031272210376688	400000
chr8	98600000	98650000	-0.3100505967	0.008528784648187633	50000
chr8	98650000	99150000	0.03175078889999994	0.4964463397299218	500000
chr8	99150000	99200000	0.5635574047	0.0014214641080312722	50000
chr8	99200000	99500000	0.03237957559999999	0.4914712153518124	300000
chr8	99500000	99700000	0.22378929190000002	0.024164889836531627	200000
chr8	99700000	99950000	0.05683173784000002	0.14925373134328357	250000
chr8	99950000	100950000	0.26036381473	0.004619758351101635	1000000
chr8	100950000	101350000	0.08881171069999999	0.13823738450604123	400000
chr8	101350000	101550000	-0.07364443580000002	0.2302771855010661	200000
chr8	101550000	101600000	-0.2873848938	0.012437810945273632	50000
chr8	101600000	102250000	-0.015885565361538383	0.5895522388059702	650000
chr8	102250000	102700000	-0.5086453270555555	0.0014214641080312722	450000
chr8	102700000	103000000	-0.08044649729999998	0.1517412935323383	300000
chr8	103000000	103450000	0.13224892115555553	0.03731343283582089	450000
chr8	103450000	103650000	-0.07387949630000001	0.2302771855010661	200000
chr8	103650000	104050000	0.04673295375000003	0.35785358919687277	400000
chr8	104050000	104100000	-0.08058459529999995	0.205046197583511	50000
chr8	104100000	104550000	0.0995539728	0.12899786780383796	450000
chr8	104550000	105250000	-0.030989780749999973	0.2999289267945984	700000
chr8	105250000	105800000	0.052390164045454574	0.13539445628997868	550000
chr8	105800000	106300000	-0.11491869844	0.0511727078891258	500000
chr8	106300000	106800000	0.12516380776000002	0.04299928926794598	500000
chr8	106800000	107200000	-0.06358899094999997	0.018834399431414357	400000
chr8	107200000	107350000	0.10942651130000003	0.11442786069651742	150000
chr8	107350000	107700000	-0.03376055570000003	0.47725657427149965	350000
chr8	107700000	109800000	0.0973243965357143	0.004619758351101635	2100000
chr8	109800000	110500000	-0.11706681511428577	0.013859275053304905	700000
chr8	110500000	111750000	-0.39917752351759994	0.0017768301350390902	1250000
chr8	111750000	111950000	-0.2851224371	0.012437810945273632	200000
chr8	111950000	112000000	-0.35671597060000004	0.005330490405117271	50000
chr8	112000000	112100000	-0.2676574464	0.01457000710732054	100000
chr8	112100000	112250000	-0.33232257344000005	0.006041222459132907	150000
chr8	112250000	112450000	-0.26616481264	0.01457000710732054	200000
chr8	112450000	114200000	-0.3784308540505714	0.0028429282160625444	1750000
chr8	114200000	114400000	-0.26549929775000003	0.012437810945273632	200000
chr8	114400000	114650000	-0.3393743867	0.005330490405117271	250000
chr8	114650000	115850000	-0.20097790040833333	0.015280739161336177	1200000
chr8	115850000	116050000	-0.3244774313	0.006396588486140725	200000
chr8	116050000	116950000	0.09067913535	0.04904051172707889	900000
chr8	116950000	117500000	-0.07670289270909093	0.03980099502487562	550000
chr8	117500000	117800000	0.05395518568333335	0.10589907604832978	300000
chr8	117800000	117950000	0.36517814640000007	0.005330490405117271	150000
chr8	117950000	118300000	-0.14521446330000007	0.047619047619047616	350000
chr8	118300000	118350000	0.15501648359999998	0.045131485429992894	50000
chr8	118350000	118850000	-0.036111160099999984	0.4310589907604833	500000
chr8	118850000	119150000	0.05390523540000003	0.32551528073916136	300000
chr8	119150000	119800000	-0.14588167330769228	0.02203269367448472	650000
chr8	119800000	119850000	-0.47463404029999995	0.0017768301350390902	50000
chr8	119850000	120100000	-0.31528069149999993	0.008528784648187633	250000
chr8	120100000	120200000	-0.6016548254999999	0.0014214641080312722	100000
chr8	120200000	120400000	-0.2225199655	0.024164889836531627	200000
chr8	120400000	120450000	0.0754015126	0.22316986496090974	50000
chr8	120450000	121100000	-0.11009191310769238	0.04584221748400853	650000
chr8	121100000	121400000	0.01294007720000001	0.7373845060412224	300000
chr8	121400000	121450000	-0.17026602970000004	0.04015636105188344	50000
chr8	121450000	121900000	0.07222819670000002	0.236318407960199	450000
chr8	121900000	121950000	-0.13331452850000003	0.05863539445628998	50000
chr8	121950000	122800000	0.044962914035294115	0.02523098791755508	850000
chr8	122800000	123250000	-0.08532693970000005	0.18407960199004975	450000
chr8	123250000	123450000	-0.3324401036000001	0.006041222459132907	200000
chr8	123450000	123550000	-0.13396682120000003	0.057569296375266525	100000
chr8	123550000	124400000	0.044381485088235265	0.1300639658848614	850000
chr8	124400000	125150000	-0.08440628633333326	0.03731343283582089	750000
chr8	125150000	125550000	0.02545851477499997	0.36673773987206826	400000
chr8	125550000	126050000	-0.11855860940000004	0.09346126510305615	500000
chr8	126050000	126350000	0.007674723399999972	0.8272921108742004	300000
chr8	126350000	126450000	-0.006182089599999996	0.8699360341151386	100000
chr8	126450000	126700000	0.11849984420000004	0.09346126510305615	250000
chr8	126700000	126750000	0.6910189282000001	0.0014214641080312722	50000
chr8	126750000	127300000	0.026902133145454553	0.5035536602700782	550000
chr8	127300000	127350000	-0.2827718327	0.012437810945273632	50000
chr8	127350000	128100000	0.06123637873999999	0.06858564321250889	750000
chr8	128100000	128400000	-0.0914267581	0.14925373134328357	300000
chr8	128400000	128750000	-0.34084939089999994	0.005330490405117271	350000
chr8	128750000	129200000	0.1043224350666667	0.11975835110163469	450000
chr8	129200000	129700000	-0.028331834840000014	0.507818052594172	500000
chr8	129700000	129850000	-0.17766455699999995	0.03731343283582089	150000
chr8	129850000	130000000	-0.08606150359999998	0.18159203980099503	150000
chr8	130000000	130950000	-0.27745235307894744	0.005330490405117271	950000
chr8	130950000	131150000	-0.04031286540000001	0.40085287846481876	200000
chr8	131150000	131400000	0.015385881020000002	0.6421464108031272	250000
chr8	131400000	131950000	-0.1016331892727273	0.0511727078891258	550000
chr8	131950000	132050000	0.21828300100000003	0.024164889836531627	100000
chr8	132050000	132800000	-0.055219615013333306	0.028784648187633263	750000
chr8	132800000	134400000	0.07148647081250001	0.04015636105188344	1600000
chr8	134400000	134750000	-0.038021026114285705	0.3205401563610519	350000
chr8	134750000	134950000	0.02570385909999995	0.5408670931058991	200000
chr8	134950000	135050000	-0.17752939730000006	0.03731343283582089	100000
chr8	135050000	135700000	0.07667083898461535	0.010305614783226724	650000
chr8	135700000	135750000	-0.07078257490000006	0.244136460554371	50000
chr8	135750000	135900000	0.040071928499999965	0.4054726368159204	150000
chr8	135900000	136050000	0.2970693839	0.008528784648187633	150000
chr8	136050000	136300000	0.07536037700000003	0.22316986496090974	250000
chr8	136300000	136650000	0.2692457833857143	0.006396588486140725	350000
chr8	136650000	136700000	-0.07457292460000003	0.228500355366027	50000
chr8	136700000	137300000	0.058596160274999996	0.024164889836531627	600000
chr8	137300000	138250000	-0.06616673021921052	0.03980099502487562	950000
chr8	138250000	138850000	0.021729868543333326	0.5597014925373134	600000
chr8	138850000	139950000	-0.03914210416272728	0.18407960199004975	1100000
chr8	139950000	141050000	0.1378527976818182	0.016702203269367447	1100000
chr8	141050000	141200000	-0.018552145200000036	0.650319829424307	150000
chr8	141200000	141450000	0.16851482939999995	0.04015636105188344	250000
chr8	141450000	141500000	0.524173028	0.0017768301350390902	50000
chr8	141500000	141650000	0.16793893130000004	0.04015636105188344	150000
chr8	141650000	142150000	0.0	1.0	500000
chr8	142150000	142200000	0.23409669209999995	0.019189765458422176	50000
chr8	142200000	142450000	-0.0753721301000001	0.22316986496090974	250000
chr8	142450000	142750000	0.03746275760000006	0.4410092395167022	300000
chr8	142800000	144350000	0.09622094848064519	0.005330490405117271	1550000
chr8	144350000	145150000	-0.06508529755000002	0.12722103766879886	800000
chr8	145200000	145300000	-0.021887065199999944	0.5973702914001422	100000
chr8	145550000	145650000	-0.021887065199999944	0.5973702914001422	100000
chr8	145750000	146150000	0.1935076307	0.031982942430703626	400000
chr8	146150000	146300000	-0.006781493699999919	0.8571428571428571	150000
chr9	0	750000	-0.044846894160000005	0.3596646072374228	750000
chr9	750000	800000	0.07839020120000006	0.19373345101500442	50000
chr9	800000	1050000	-0.27069116359999995	0.01323918799646955	250000
chr9	1050000	1900000	0.019006999129999994	0.7171226831421006	850000
chr9	1900000	2000000	-0.24765966756	0.018093556928508385	100000
chr9	2000000	2100000	0.2510279965	0.016328331862312445	100000
chr9	2100000	2550000	-0.18753523865555558	0.00353045013239188	450000
chr9	2550000	2900000	0.03344269470000005	0.5441306266548985	350000
chr9	2900000	3200000	-0.0011373577999999884	0.968667255075022	300000
chr9	3200000	3550000	0.2029027621714286	0.01412180052956752	350000
chr9	3550000	4100000	-0.10222500597272727	0.00353045013239188	550000
chr9	4100000	4350000	0.019685039399999993	0.7171226831421006	250000
chr9	4350000	4650000	-0.29118547679999995	0.00794351279788173	300000
chr9	4650000	4700000	0.11038932629999998	0.09841129744042365	50000
chr9	4700000	6150000	-0.09042371862068967	0.07766990291262135	1450000
chr9	6150000	6350000	-0.4203193351	0.003089143865842895	200000
chr9	6350000	6600000	0.04242782159999996	0.3879082082965578	250000
chr9	6600000	6800000	-0.01832895889999997	0.7193292144748455	200000
chr9	6800000	7700000	0.05998104406055555	0.03574580759046778	900000
chr9	7700000	8150000	-0.04076504323777778	0.2740511915269197	450000
chr9	8150000	8850000	0.016466691657857146	0.5692850838481907	700000
chr9	8850000	8950000	-0.06325459318000001	0.2586054721977052	100000
chr9	8950000	9350000	0.04898840772	0.21359223300970873	400000
chr9	9350000	10950000	-0.049295986431562494	0.10767872903795234	1600000
chr9	10950000	11600000	0.030264486173076914	0.5441306266548985	650000
chr9	11600000	12200000	-0.05035542435500001	0.2586054721977052	600000
chr9	12200000	12900000	0.06371078617142854	0.206090026478376	700000
chr9	12900000	13100000	-0.015441819799999978	0.7691968225948809	200000
chr9	13100000	13300000	0.1012248469	0.10944395410414828	200000
chr9	13300000	13350000	-0.045756780399999974	0.3879082082965578	50000
chr9	13350000	14400000	0.15051451901428572	0.00264783759929391	1050000
chr9	14400000	14700000	-0.008005249300000017	0.8927625772285966	300000
chr9	14700000	15100000	0.032338145225	0.19549867608120036	400000
chr9	15100000	15400000	-0.08713910759999999	0.1500441306266549	300000
chr9	15400000	15850000	0.09337999422222215	0.09311562224183584	450000
chr9	15850000	16000000	-0.10551181110000007	0.10326566637246248	150000
chr9	16000000	16200000	0.017847768999999958	0.7193292144748455	200000
chr9	16200000	18200000	-0.037937445315	0.09841129744042365	2000000
chr9	18200000	18250000	0.4892388451	0.00264783759929391	50000
chr9	18250000	18450000	-0.007983377099999966	0.8927625772285966	200000
chr9	18450000	18900000	0.06969476035555557	0.005736981465136805	450000
chr9	18900000	19050000	-0.10905511810000007	0.09929390997352162	150000
chr9	19050000	19500000	0.022681539766666686	0.5692850838481907	450000
chr9	19500000	19900000	-0.006233595800000019	0.8954104148278905	400000
chr9	19900000	20350000	0.051040147733333346	0.2740511915269197	450000
chr9	20350000	20550000	-0.042825896799999985	0.4170344218887908	200000
chr9	20550000	21100000	0.014930804072727268	0.676522506619594	550000
chr9	21100000	21450000	-0.0995594300857143	0.09532215357458076	350000
chr9	21450000	21700000	0.006277340300000045	0.8954104148278905	250000
chr9	21700000	21800000	-0.138079615	0.06090026478375993	100000
chr9	21800000	21950000	0.01408573930000001	0.8186231244483672	150000
chr9	21950000	22250000	-0.06122047239999995	0.2740511915269197	300000
chr9	22250000	22700000	0.04426217558888882	0.3327449249779347	450000
chr9	22700000	22750000	-0.08186789150000001	0.18270079435127978	50000
chr9	22750000	23000000	0.019488188939999995	0.648278905560459	250000
chr9	23000000	23400000	-0.004254155700000012	0.9333627537511032	400000
chr9	23400000	26150000	0.04280760359090909	0.08031774051191527	2750000
chr9	26150000	26350000	-0.18508311461000002	0.018534863195057368	200000
chr9	26350000	26800000	0.09967191598444443	0.07325684024713151	450000
chr9	26800000	26850000	-0.19017935260000002	0.03089143865842895	50000
chr9	26850000	27650000	0.0788167104	0.023389232127096204	800000
chr9	27650000	28100000	-0.01478565180000001	0.7691968225948809	450000
chr9	28100000	28550000	0.024117818613333328	0.648278905560459	450000
chr9	28550000	32350000	-0.10097935949934209	0.04148278905560459	3800000
chr9	32350000	32600000	0.08737970249999993	0.1500441306266549	250000
chr9	32600000	33000000	-0.011942257300000009	0.8186231244483672	400000
chr9	33000000	33250000	0.025131233599999914	0.648278905560459	250000
chr9	33250000	33550000	-0.02451881019999998	0.5692850838481907	300000
chr9	33550000	33800000	-0.42541119864	0.003089143865842895	250000
chr9	33800000	33950000	0.0016404198999999675	0.968667255075022	150000
chr9	33950000	34400000	-0.01208078158888886	0.1235657546337158	450000
chr9	34400000	34700000	0.018110236199999963	0.7193292144748455	300000
chr9	34700000	35600000	-0.05990692133333329	0.09620476610767872	900000
chr9	35600000	35850000	0.034798775199999965	0.5070609002647838	250000
chr9	35850000	36300000	-0.05831146099999997	0.10767872903795234	450000
chr9	36300000	36700000	0.0074584426999999565	0.8927625772285966	400000
chr9	36700000	37100000	-0.22200349949999998	0.018976169461606355	400000
chr9	37100000	37350000	0.004374453199999961	0.9333627537511032	250000
chr9	37350000	37800000	-0.16313308053333334	0.018534863195057368	450000
chr9	37800000	38100000	0.03351560220000005	0.4170344218887908	300000
chr9	38100000	38450000	-0.18573928259999997	0.032215357458075904	350000
chr9	38450000	38850000	-0.3555664917125	0.0048543689320388345	400000
chr9	38850000	39200000	-0.11189538804285706	0.04854368932038835	350000
chr9	39750000	39850000	-0.0781496062999999	0.19373345101500442	100000
chr9	40050000	40100000	-0.0781496062999999	0.19373345101500442	50000
chr9	40250000	40400000	0.09500218719999998	0.1235657546337158	150000
chr9	40500000	40550000	0.09500218719999998	0.1235657546337158	50000
chr9	40550000	40800000	-0.06472003500000001	0.2586054721977052	250000
chr9	40800000	40850000	0.12833552059999997	0.07325684024713151	50000
chr9	41000000	41050000	0.10996281720000001	0.09841129744042365	50000
chr9	41250000	41300000	0.10996281720000001	0.09841129744042365	50000
chr9	41950000	42000000	0.10996281720000001	0.09841129744042365	50000
chr9	42150000	42300000	-0.16406386700000003	0.04280670785525154	150000
chr9	42500000	42550000	-0.16406386700000003	0.04280670785525154	50000
chr9	42900000	42950000	-0.07351268590000004	0.21359223300970873	50000
chr9	43150000	43200000	-0.07351268590000004	0.21359223300970873	50000
chr9	43300000	43900000	-0.09451006122500004	0.04854368932038835	600000
chr9	44050000	44300000	-0.11698381449999999	0.09311562224183584	250000
chr9	44350000	44500000	0.016874453199999973	0.7691968225948809	150000
chr9	44700000	44950000	0.11085957999999999	0.09620476610767872	250000
chr9	45100000	45150000	0.11085957999999999	0.09620476610767872	50000
chr9	45350000	45450000	-0.05028433939999999	0.3596646072374228	100000
chr9	45450000	45500000	0.014993438400000003	0.7691968225948809	50000
chr9	45600000	45650000	0.014993438400000003	0.7691968225948809	50000
chr9	45700000	45750000	0.014993438400000003	0.7691968225948809	50000
chr9	46100000	46150000	0.026804461999999973	0.6085613415710504	50000
chr9	47150000	47250000	0.026804461999999973	0.6085613415710504	100000
chr9	65550000	65650000	0.026804461999999973	0.6085613415710504	100000
chr9	66200000	66350000	-0.06768372700000003	0.235657546337158	150000
chr9	66450000	66550000	0.08456911630000002	0.15931156222418358	100000
chr9	66650000	66750000	0.08456911630000002	0.15931156222418358	100000
chr9	66750000	66800000	-0.12277996499999999	0.08031774051191527	50000
chr9	66800000	66900000	0.0077755906000000485	0.8927625772285966	100000
chr9	67200000	67250000	0.0077755906000000485	0.8927625772285966	50000
chr9	67250000	67350000	0.24742454070000006	0.00706090026478376	100000
chr9	67650000	67750000	0.17867454070000005	0.03574580759046778	100000
chr9	67850000	68000000	0.17867454070000002	0.03574580759046778	150000
chr9	68100000	68550000	-0.0827974628	0.16107678729037953	450000
chr9	68650000	68850000	0.08786362645000001	0.07325684024713151	200000
chr9	68950000	69550000	0.05475448380833333	0.05648720211827008	600000
chr9	69750000	70000000	0.14587707789999999	0.05648720211827008	250000
chr9	70150000	70200000	0.4014326334	0.00353045013239188	50000
chr9	70450000	70650000	0.355500874875	0.00353045013239188	200000
chr9	70700000	70750000	0.21770559929999997	0.019858781994704325	50000
chr9	70800000	70900000	0.21770559929999997	0.019858781994704325	100000
chr9	70900000	71300000	-0.01982720910000002	0.7171226831421006	400000
chr9	71300000	71650000	0.008880140000000009	0.8490732568402471	350000
chr9	71650000	71850000	-0.07569991250000002	0.206090026478376	200000
chr9	71850000	72750000	0.09569359388888891	0.04280670785525154	900000
chr9	72750000	73050000	-0.028266258333333332	0.5030891438658429	300000
chr9	73050000	73200000	-0.3217629046999999	0.005736981465136805	150000
chr9	73200000	73250000	0.15601487310000006	0.05030891438658429	50000
chr9	73250000	74250000	-0.10144575678000001	0.019858781994704325	1000000
chr9	74250000	74650000	0.178387467225	0.016328331862312445	400000
chr9	74650000	74900000	-0.01811023619999999	0.7193292144748455	250000
chr9	74900000	74950000	0.6354330709	0.00088261253309797	50000
chr9	74950000	75200000	-0.025678040200000085	0.6085613415710504	250000
chr9	75200000	75500000	-0.22764654419999997	0.018534863195057368	300000
chr9	75500000	75850000	-0.004549431299999962	0.9333627537511032	350000
chr9	75850000	76800000	0.02360708201273684	0.6085613415710504	950000
chr9	76800000	77150000	-0.039988751418000006	0.09620476610767872	350000
chr9	77150000	77850000	0.11463879516857145	0.028684907325684024	700000
chr9	77850000	78450000	-0.0222222222225	0.31685789938217124	600000
chr9	78450000	79300000	0.03463280327294117	0.3327449249779347	850000
chr9	79300000	79750000	-0.050072907566666665	0.21359223300970873	450000
chr9	79750000	80050000	0.13346456700000006	0.07325684024713151	300000
chr9	80050000	80100000	-0.2602362204	0.01500441306266549	50000
chr9	80100000	80650000	0.01300405630909088	0.7193292144748455	550000
chr9	80650000	80950000	-0.1106736658	0.09841129744042365	300000
chr9	80950000	81000000	0.019881889799999997	0.7171226831421006	50000
chr9	81000000	81150000	-0.05885826770000002	0.28596646072374227	150000
chr9	81150000	81900000	-0.26350393697333335	0.00706090026478376	750000
chr9	81900000	82100000	-0.04326334210000002	0.4170344218887908	200000
chr9	82100000	82150000	0.40030621169999997	0.00353045013239188	50000
chr9	82150000	82400000	0.13919510059999995	0.06090026478375993	250000
chr9	82400000	82500000	0.4780839895	0.00264783759929391	100000
chr9	82500000	82800000	0.19461942259999998	0.028684907325684024	300000
chr9	82800000	83200000	0.022112860890000002	0.676522506619594	400000
chr9	83200000	83500000	-0.14733158350999997	0.05648720211827008	300000
chr9	83500000	83550000	-0.45844269471000004	0.00264783759929391	50000
chr9	83550000	83750000	-0.17497812780000005	0.03751103265666372	200000
chr9	83750000	84000000	-0.29094488190000006	0.00794351279788173	250000
chr9	84000000	84350000	-0.0677165354	0.235657546337158	350000
chr9	84350000	84500000	-0.5191601050000001	0.00264783759929391	150000
chr9	84500000	84800000	0.007152230999999995	0.8927625772285966	300000
chr9	84800000	85300000	-0.038713910745	0.2586054721977052	500000
chr9	85300000	85550000	0.07027559057	0.22241835834068843	250000
chr9	85550000	85750000	0.3172572178	0.005736981465136805	200000
chr9	85750000	85850000	-0.10793963260000003	0.10326566637246248	100000
chr9	85850000	87600000	0.08226471688285712	0.005736981465136805	1750000
chr9	87600000	88150000	-0.08184999605818183	0.1354810238305384	550000
chr9	88150000	88900000	0.09650918634666666	0.09532215357458076	750000
chr9	88900000	89250000	0.5016060492342858	0.002206531332744925	350000
chr9	89250000	89600000	0.22489376327285715	0.018534863195057368	350000
chr9	89600000	89950000	0.09144169477285714	0.13062665489849956	350000
chr9	89950000	90950000	-0.15230752407000003	0.018534863195057368	1000000
chr9	90950000	91000000	0.22346894139999995	0.018976169461606355	50000
chr9	91000000	91150000	-0.037642169800000014	0.4735216240070609	150000
chr9	91150000	91300000	-0.25286526689999994	0.015445719329214475	150000
chr9	91300000	91350000	-0.4528652669	0.00264783759929391	50000
chr9	91350000	91500000	-0.11690726159999998	0.09311562224183584	150000
chr9	91500000	91800000	-0.4419072616	0.003089143865842895	300000
chr9	91800000	92000000	-0.18912948379999994	0.03089143865842895	200000
chr9	92000000	92050000	0.2580927384	0.01500441306266549	50000
chr9	92050000	92250000	-0.02930883640000001	0.5692850838481907	200000
chr9	92250000	92350000	0.027635608000000006	0.6085613415710504	100000
chr9	92400000	92450000	0.027635608000000006	0.6085613415710504	50000
chr9	92450000	92550000	-0.045855205600000004	0.3879082082965578	100000
chr9	92650000	93650000	0.031161417321099998	0.206090026478376	1000000
chr9	93650000	94000000	-0.004877515300000024	0.9333627537511032	350000
chr9	94000000	94300000	0.1361767278999999	0.06928508384819064	300000
chr9	94300000	95100000	-0.011260115987500006	0.8186231244483672	800000
chr9	95100000	95550000	0.22910469526666669	0.00794351279788173	450000
chr9	95550000	95800000	-0.06404199479999996	0.01412180052956752	250000
chr9	95800000	96000000	0.0404199475	0.4457193292144748	200000
chr9	96000000	96200000	-0.13272090990000002	0.07325684024713151	200000
chr9	96200000	96650000	0.10925439873333335	0.03795233892321271	450000
chr9	96650000	96800000	-0.08213035869999996	0.18270079435127978	150000
chr9	96800000	97050000	0.08035870519999999	0.18402471315092675	250000
chr9	97050000	97400000	-0.016576052957142855	0.7171226831421006	350000
chr9	97400000	97450000	-0.633639545	0.00088261253309797	50000
chr9	97450000	97900000	0.025153105899999972	0.648278905560459	450000
chr9	97900000	98300000	-0.05334645672499999	0.04280670785525154	400000
chr9	98300000	98350000	0.022528433900000033	0.676522506619594	50000
chr9	98350000	98550000	-0.05096237969999995	0.3596646072374228	200000
chr9	98550000	98750000	0.11384514439999999	0.09532215357458076	200000
chr9	98750000	98800000	-0.185367454	0.032215357458075904	50000
chr9	98800000	99600000	0.05325213255624999	0.045454545454545456	800000
chr9	99600000	99800000	-0.06817585299999995	0.235657546337158	200000
chr9	99800000	100000000	0.013845144399999981	0.8186231244483672	200000
chr9	100000000	100350000	-0.10894575680000004	0.09929390997352162	350000
chr9	100350000	100400000	0.17451881009999998	0.03795233892321271	50000
chr9	100400000	100750000	-0.3477034121	0.0048543689320388345	350000
chr9	100750000	101050000	-0.16603237096666665	0.01323918799646955	300000
chr9	101050000	101100000	-0.5751968504	0.001323918799646955	50000
chr9	101100000	101550000	-0.23075240589999998	0.018534863195057368	450000
chr9	101550000	101600000	-0.691863517	0.000441306266548985	50000
chr9	101600000	101900000	0.019422572199999988	0.7171226831421006	300000
chr9	101900000	102550000	-0.48267211793846143	0.002206531332744925	650000
chr9	102550000	102900000	-0.03595175608571428	0.18270079435127978	350000
chr9	102900000	103350000	0.11122047236666661	0.05648720211827008	450000
chr9	103350000	103400000	-0.65955818027	0.000441306266548985	50000
chr9	103400000	104050000	0.007535836870692309	0.8186231244483672	650000
chr9	104050000	104100000	-0.29289151357	0.00794351279788173	50000
chr9	104100000	104350000	0.04569116360000003	0.3879082082965578	250000
chr9	104350000	105400000	-0.07673103362980954	0.08958517210944396	1050000
chr9	105400000	107500000	-0.3367037453705238	0.00264783759929391	2100000
chr9	107500000	107550000	0.4668853893	0.00264783759929391	50000
chr9	107550000	108200000	-0.13890571368461532	0.03574580759046778	650000
chr9	108200000	108300000	0.42167541560000005	0.003089143865842895	100000
chr9	108300000	108500000	0.03847331590000003	0.46910856134157103	200000
chr9	108500000	108550000	-0.2869860017	0.00794351279788173	50000
chr9	108550000	109400000	0.05146286861411765	0.13768755516328332	850000
chr9	109400000	109600000	-0.06351706040000002	0.2586054721977052	200000
chr9	109600000	111900000	0.1293231009369566	0.0048543689320388345	2300000
chr9	111900000	112300000	-0.39683945760000006	0.003089143865842895	400000
chr9	112300000	112500000	0.038888888899999974	0.46910856134157103	200000
chr9	112500000	112750000	-0.10411198602000007	0.00794351279788173	250000
chr9	112750000	112950000	0.02607174099999998	0.6085613415710504	200000
chr9	112950000	114150000	-0.05735910615833332	0.07766990291262135	1200000
chr9	114150000	114600000	0.014916885400000024	0.7691968225948809	450000
chr9	114600000	116850000	-0.07818800431333336	0.00794351279788173	2250000
chr9	116850000	117100000	0.024212598400000007	0.648278905560459	250000
chr9	117100000	117200000	-0.02856517930000002	0.5692850838481907	100000
chr9	117200000	118450000	0.08089151358000002	0.05339805825242718	1250000
chr9	118450000	119450000	-0.10081474188500002	0.04148278905560459	1000000
chr9	119450000	119500000	0.6134951880999999	0.001323918799646955	50000
chr9	119500000	120550000	-0.049742740496190464	0.019858781994704325	1050000
chr9	120550000	120600000	0.31544181980999997	0.00706090026478376	50000
chr9	120600000	121250000	-0.02839020123000001	0.6085613415710504	650000
chr9	121250000	121450000	0.10376202977999999	0.10767872903795234	200000
chr9	121450000	122300000	-0.018188719058235294	0.3596646072374228	850000
chr9	122300000	123100000	0.026692366596875003	0.4457193292144748	800000
chr9	123100000	123550000	-0.030703800877777798	0.3596646072374228	450000
chr9	123550000	125850000	0.07902116858695656	0.04280670785525154	2300000
chr9	125850000	126650000	-0.08480014215625	0.06090026478375993	800000
chr9	126650000	127000000	-0.20872703420000002	0.023389232127096204	350000
chr9	127000000	127200000	-0.1352580928	0.06928508384819064	200000
chr9	127200000	127350000	-0.4922134732999999	0.00264783759929391	150000
chr9	127350000	127550000	-0.10113735787499997	0.08958517210944396	200000
chr9	127550000	127700000	0.07898075240000002	0.19373345101500442	150000
chr9	127700000	127850000	-0.05909886270000009	0.28596646072374227	150000
chr9	127850000	127900000	0.16399825019999992	0.04280670785525154	50000
chr9	127900000	128750000	-0.07627116464117652	0.06090026478375993	850000
chr9	128750000	129600000	-0.34332381248823524	0.003089143865842895	850000
chr9	129600000	130750000	0.09643672258695657	0.03618711385701677	1150000
chr9	130750000	130900000	-0.03654855639999999	0.5030891438658429	150000
chr9	130900000	132800000	0.03138612608157896	0.206090026478376	1900000
chr9	132800000	133100000	-0.06823964711666665	0.06928508384819064	300000
chr9	133200000	133600000	-0.07490157479999993	0.206090026478376	400000
chr9	133600000	133750000	0.0741907262	0.206090026478376	150000
chr9	133750000	134450000	-0.06884451939999998	0.13768755516328332	700000
chr9	134450000	134650000	0.10492125990000001	0.10767872903795234	200000
chr9	134650000	135850000	-0.09948144502916671	0.007502206531332745	1200000
chr9	135850000	136050000	0.019160105000000094	0.7171226831421006	200000
chr9	136050000	136200000	-0.07480314960000001	0.206090026478376	150000
chr9	136200000	137050000	0.0347820493117647	0.06928508384819064	850000
chr9	137050000	137600000	-0.16409965803636364	0.018534863195057368	550000
chr9	137600000	137750000	0.192191601	0.029567519858781994	150000
chr9	137750000	138300000	-0.013725841081818214	0.7691968225948809	550000
chr9	138300000	138350000	0.14757217849999998	0.05648720211827008	50000
chr9	138350000	138600000	-0.17465004369999998	0.03795233892321271	250000
chr9	138600000	138850000	0.24267279090000002	0.018534863195057368	250000
chr9	138850000	139200000	0.0010061242000000137	0.968667255075022	350000
chr9	139200000	139650000	-0.15161854770000005	0.052515445719329215	450000
chr9	139650000	140150000	0.01618547690000005	0.7691968225948809	500000
chr9	140150000	141150000	-0.05972112860999999	0.10767872903795234	1000000
chrX	2700000	2850000	0.07357398580000007	0.29740791268758526	150000
chrX	2850000	3200000	-0.07585130149999997	0.2813778990450205	350000
chrX	3200000	3300000	0.001432070899999971	0.9877216916780355	100000
chrX	3300000	3450000	-0.030751837200000076	0.6053888130968622	150000
chrX	3450000	3750000	0.03568602119999997	0.5719645293315143	300000
chrX	3850000	3900000	0.5766696277000001	0.0006821282401091405	50000
chrX	3900000	4150000	0.03529031730000001	0.5746930422919508	250000
chrX	4150000	5900000	-0.06385267052400001	0.10402455661664393	1750000
chrX	5900000	7700000	0.08866681024722221	0.0010231923601637107	1800000
chrX	7700000	8150000	-0.09175422695555552	0.15654843110504774	450000
chrX	8150000	8650000	-0.36319685589999995	0.004433833560709414	500000
chrX	8650000	8700000	-0.1631968559	0.062414733969986355	50000
chrX	8700000	8900000	-0.25687367089999996	0.0126193724420191	200000
chrX	8900000	9050000	-0.0484427576	0.4590723055934516	150000
chrX	9050000	9100000	0.08489057570000003	0.24249658935879945	50000
chrX	9100000	9300000	-0.034547363399999975	0.5845839017735335	200000
chrX	9300000	9350000	0.13556757919999995	0.11289222373806275	50000
chrX	9350000	10150000	-0.09600157475000005	0.02592087312414734	800000
chrX	10150000	10250000	0.1425664217	0.09788540245566166	100000
chrX	10250000	11100000	-0.05611899936470588	0.14358799454297408	850000
chrX	11100000	11550000	0.07139716638888885	0.23465211459754434	450000
chrX	11550000	12700000	-0.1292487245956522	0.01330150068212824	1150000
chrX	12700000	13500000	0.035815903499999954	0.1892905866302865	800000
chrX	13500000	14850000	-0.047044783640740766	0.045020463847203276	1350000
chrX	14850000	15000000	0.038224447500000036	0.5395634379263301	150000
chrX	15000000	15200000	-0.0997065869	0.19201909959072305	200000
chrX	15200000	15250000	0.17385663149999997	0.05218281036834925	50000
chrX	15250000	16100000	-0.0984433116941176	0.015006821282401092	850000
chrX	16100000	16300000	0.048104928774999944	0.17360163710777626	200000
chrX	16300000	16700000	-0.05915367842500002	0.045702592087312414	400000
chrX	16700000	16750000	0.017168699100000073	0.772169167803547	50000
chrX	16750000	17800000	-0.08300191379047621	0.06718963165075034	1050000
chrX	17800000	17850000	0.20766642440000005	0.031036834924965895	50000
chrX	17850000	18600000	-0.09141995745999995	0.09379263301500682	750000
chrX	18600000	18850000	0.062133570299999996	0.36732605729877216	250000
chrX	18850000	20600000	-0.0683922274285714	0.14358799454297408	1750000
chrX	20600000	21000000	0.030563406799999998	0.6053888130968622	400000
chrX	21000000	22000000	-0.10915583190000003	0.045702592087312414	1000000
chrX	22000000	22100000	0.03752456329999998	0.5446793997271487	100000
chrX	22100000	22400000	-0.054429459700000016	0.42598908594815826	300000
chrX	22400000	22450000	0.06969232010000004	0.32332878581173263	50000
chrX	22450000	23300000	-0.11927231042352941	0.06718963165075034	850000
chrX	23300000	24100000	0.015892756200000024	0.6998635743519782	800000
chrX	24100000	25150000	-0.06696533524761912	0.13062755798090042	1050000
chrX	25150000	25650000	-0.18728525665	0.0047748976807639835	500000
chrX	25650000	26300000	-0.12639122705384614	0.07844474761255116	650000
chrX	26300000	26800000	-0.32427252413999996	0.005115961800818554	500000
chrX	26800000	27000000	0.052965086500000036	0.44099590723055937	200000
chrX	27000000	27300000	-0.041287786999999965	0.5088676671214188	300000
chrX	27300000	28500000	-0.3173519699583333	0.004433833560709414	1200000
chrX	28500000	29600000	-0.17261005433636364	0.034106412005457026	1100000
chrX	29600000	29950000	-0.20937306520000007	0.029331514324693043	350000
chrX	29950000	30000000	-0.2046892245	0.03240109140518418	50000
chrX	30000000	30650000	-0.2781679598153846	0.008185538881309686	650000
chrX	30650000	30950000	-0.17458881800000003	0.05218281036834925	300000
chrX	30950000	31000000	-0.23435893290000004	0.018417462482946793	50000
chrX	31000000	31650000	-0.04783439660000001	0.17360163710777626	650000
chrX	31650000	31700000	-0.53546528839	0.0006821282401091405	50000
chrX	31700000	32300000	0.012544079239999992	0.8441336971350614	600000
chrX	32300000	32400000	-0.0472260357	0.47646657571623463	100000
chrX	32400000	33600000	0.004177097634166666	0.9113233287858117	1200000
chrX	33600000	33650000	-0.009496890896	0.8700545702592087	50000
chrX	33650000	34650000	0.05770114941440001	0.007844474761255117	1000000
chrX	34650000	35450000	-0.06471674874375001	0.14256480218281037	800000
chrX	35450000	36700000	0.0327345554512	0.10402455661664393	1250000
chrX	36700000	37100000	-0.06386612023750002	0.334924965893588	400000
chrX	37150000	37350000	-0.08394505907500001	0.021145975443383355	200000
chrX	37350000	37700000	0.06964386652857146	0.008185538881309686	350000
chrX	37700000	38500000	-0.029217812049999972	0.40859481582537516	800000
chrX	38500000	39800000	0.10881895570384617	0.023874488403819918	1300000
chrX	39800000	40500000	-0.02606530454285711	0.44099590723055937	700000
chrX	40500000	41000000	0.009453821100000037	0.8700545702592087	500000
chrX	41000000	41400000	-0.014828124599999964	0.17939972714870395	400000
chrX	41400000	41650000	0.07531292899999997	0.28274215552523874	250000
chrX	41650000	42350000	-0.06437281526428566	0.13847203274215553	700000
chrX	42350000	42750000	0.10793022697499999	0.049795361527967257	400000
chrX	42750000	43000000	-0.02344612240000002	0.6790586630286494	250000
chrX	43000000	43200000	0.0891975558	0.23431105047748976	200000
chrX	43200000	43350000	-0.03492422403333331	0.5255798090040927	150000
chrX	43350000	43950000	0.14058610817499995	0.005115961800818554	600000
chrX	43950000	44250000	-0.0200328407	0.7322646657571623	300000
chrX	44250000	44600000	0.05756817139999992	0.4024556616643929	350000
chrX	44600000	44650000	-0.06655360840000002	0.34208731241473395	50000
chrX	44650000	47550000	0.05378387686551721	0.1364256480218281	2900000
chrX	47550000	47850000	-0.003596328300000007	0.9553206002728513	300000
chrX	47850000	48200000	0.06298419879999995	0.3639154160982265	350000
chrX	48200000	48300000	-0.14076287379999997	0.10129604365620737	100000
chrX	48300000	49200000	0.04264986944999999	0.34379263301500684	900000
chrX	49350000	50900000	0.11137381370645161	0.010231923601637109	1550000
chrX	50900000	51100000	-0.015871221300000016	0.7878581173260573	200000
chrX	51100000	51400000	0.050378206750000015	0.05081855388813097	300000
chrX	51400000	51800000	-0.04296212548749992	0.1892905866302865	400000
chrX	51800000	52100000	0.049218013900000024	0.4542974079126876	300000
chrX	52550000	52700000	-0.03166168680000003	0.6030013642564802	150000
chrX	52800000	53000000	-0.03166168680000003	0.6030013642564802	200000
chrX	53000000	53700000	0.004899189700000028	0.9345156889495225	700000
chrX	53700000	54350000	-0.05905242297692305	0.23465211459754434	650000
chrX	54350000	54750000	0.05857156316249995	0.34379263301500684	400000
chrX	54750000	55450000	-0.007166122585714331	0.8973396998635743	700000
chrX	55450000	55550000	0.10793830250000003	0.1776944065484311	100000
chrX	55550000	55850000	-0.054932838033333375	0.4184856753069577	300000
chrX	55850000	55900000	0.1132951089	0.16473396998635745	50000
chrX	55900000	56200000	-0.04532558069999998	0.48124147339699863	300000
chrX	56200000	58550000	0.15364280586170212	0.009208731241473396	2350000
chrX	61700000	62350000	-0.018977630600000017	0.7462482946793997	650000
chrX	62400000	63150000	-0.07718036374666666	0.008526603001364257	750000
chrX	63150000	63500000	0.008044823371428604	0.8622100954979536	350000
chrX	63500000	63700000	-0.01427763870000004	0.8185538881309686	200000
chrX	63700000	63750000	0.12623758379999997	0.1330150068212824	50000
chrX	63750000	64300000	-0.04062412051818183	0.10402455661664393	550000
chrX	64300000	65700000	0.0648711944	0.009208731241473396	1400000
chrX	65700000	65800000	-0.07914614120000002	0.26637107776261937	100000
chrX	65800000	66200000	0.1421969635375	0.023192360163710776	400000
chrX	66200000	66250000	-0.08177878279999999	0.2489768076398363	50000
chrX	66250000	66750000	0.07278796196000001	0.3093451568894952	500000
chrX	66750000	66850000	-0.12861719030000002	0.12994542974079126	100000
chrX	66850000	67800000	0.11545936634210524	0.08424283765347886	950000
chrX	67800000	67850000	-0.045417104099999994	0.48090040927694405	50000
chrX	67850000	68150000	0.009755309700000048	0.8669849931787176	300000
chrX	68150000	68300000	-0.03392285119999994	0.5879945429740792	150000
chrX	68300000	70550000	0.07873219259333332	0.062414733969986355	2250000
chrX	70550000	70650000	-0.013405475200000017	0.8332196452933152	100000
chrX	70650000	70900000	0.01352660909999992	0.830150068212824	250000
chrX	71000000	71200000	-0.09155764624999996	0.1364256480218281	200000
chrX	71200000	71600000	0.013466042112500048	0.2881991814461119	400000
chrX	71600000	71950000	-0.03310452499999994	0.5879945429740792	350000
chrX	71950000	72000000	0.3497994563000001	0.005115961800818554	50000
chrX	72200000	73800000	-0.11911230786249997	0.005115961800818554	1600000
chrX	73800000	73850000	0.4253358098	0.002728512960436562	50000
chrX	73850000	74300000	-0.05100182154444447	0.08628922237380628	450000
chrX	74300000	74550000	0.030251150800000015	0.6084583901773534	250000
chrX	74550000	74600000	-0.05940402159999997	0.38778990450204637	50000
chrX	74600000	74900000	0.15136881210000006	0.07571623465211459	300000
chrX	74900000	75050000	-0.04936337460000001	0.4536152796725784	150000
chrX	75050000	75300000	0.030261918200000015	0.6084583901773534	250000
chrX	75300000	75450000	-0.12435866370000004	0.1364256480218281	150000
chrX	75450000	75500000	0.2714258796	0.010231923601637109	50000
chrX	75500000	76200000	-0.020931153685714295	0.7233969986357435	700000
chrX	76200000	76300000	0.1971573932	0.04058663028649386	100000
chrX	76300000	76550000	-0.066308649	0.34345156889495226	250000
chrX	76550000	76650000	0.18081778780000002	0.048431105047748974	100000
chrX	76700000	76800000	0.18081778780000002	0.048431105047748974	100000
chrX	76800000	77400000	-0.13717865886666666	0.058663028649386086	600000
chrX	77400000	77450000	0.16249158799999996	0.062414733969986355	50000
chrX	77450000	78050000	-0.0007268029000000453	0.9945429740791268	600000
chrX	78050000	78600000	0.10886283492363638	0.06753069577080491	550000
chrX	78600000	78750000	-0.10186546068000002	0.1892905866302865	150000
chrX	78750000	78800000	0.024598239519999995	0.6739427012278308	50000
chrX	78800000	80650000	-0.08137543987810811	0.004433833560709414	1850000
chrX	80650000	81000000	0.028808312469999993	0.6217598908594816	350000
chrX	81000000	82000000	-0.028848690407700002	0.5446793997271487	1000000
chrX	82000000	83300000	0.03280966254607692	0.4519099590723056	1300000
chrX	83300000	84350000	-0.0633946436952381	0.3274215552523875	1050000
chrX	84350000	84400000	0.2716250774	0.010231923601637109	50000
chrX	84400000	85350000	-0.06877226983894735	0.14733969986357434	950000
chrX	85350000	86550000	0.033309779541083336	0.048431105047748974	1200000
chrX	86550000	86600000	-0.36207704112999994	0.0047748976807639835	50000
chrX	86600000	86650000	0.07930226920000005	0.26637107776261937	50000
chrX	86650000	86950000	-0.08463215699999993	0.24249658935879945	300000
chrX	86950000	87900000	0.08633568093684212	0.002728512960436562	950000
chrX	87900000	88100000	-0.0063635629499999985	0.9120054570259208	200000
chrX	88100000	88650000	0.007435903083636366	0.9010914051841746	550000
chrX	88650000	89150000	-0.115758163022	0.023874488403819918	500000
chrX	89200000	89650000	-0.08133731726666665	0.07844474761255116	450000
chrX	89650000	89800000	0.0646208511666667	0.23635743519781718	150000
chrX	89800000	91050000	-0.08506285497599998	0.0126193724420191	1250000
chrX	91050000	91150000	0.001039058899999945	0.9918144611186903	100000
chrX	91150000	92000000	-0.03832388806941176	0.023874488403819918	850000
chrX	92000000	93000000	0.035749010732	0.0252387448840382	1000000
chrX	93000000	93150000	-0.036076341219999995	0.5644611186903138	150000
chrX	93150000	93900000	0.029877520259866668	0.0688949522510232	750000
chrX	93900000	94100000	-0.050084793669999995	0.4519099590723056	200000
chrX	94100000	94250000	0.0037793749500000043	0.9553206002728513	150000
chrX	94250000	95100000	-0.03457934898211764	0.045702592087312414	850000
chrX	95100000	95600000	0.04852082155400001	0.0665075034106412	500000
chrX	95600000	96950000	-0.11081201526296296	0.0665075034106412	1350000
chrX	96950000	98300000	0.026991803778888893	0.019440654843110503	1350000
chrX	98300000	98350000	-0.007327249729999999	0.9041609822646658	50000
chrX	98350000	98950000	0.010172548384333333	0.6367667121418826	600000
chrX	98950000	99200000	-0.03815984279	0.5419508867667121	250000
chrX	99200000	99850000	0.07158532066846156	0.1688267394270123	650000
chrX	99850000	101150000	-0.062163387753846146	0.10914051841746249	1300000
chrX	101150000	101400000	0.21892863873999996	0.008185538881309686	250000
chrX	101400000	101450000	-0.07963606020000003	0.25886766712141884	50000
chrX	101750000	101900000	-0.07963606020000003	0.25886766712141884	150000
chrX	101900000	102200000	0.06404210080000006	0.3564120054570259	300000
chrX	102200000	102900000	-0.03493499149999995	0.5037517053206003	700000
chrX	102900000	103050000	0.007844087299999969	0.8987039563437926	150000
chrX	103050000	103750000	-0.05769199712142854	0.009208731241473396	700000
chrX	103750000	103850000	0.07953376940000001	0.25886766712141884	100000
chrX	103850000	104000000	-0.03540875933333335	0.33731241473397	150000
chrX	104000000	104400000	0.08713222435	0.12244201909959072	400000
chrX	104400000	105250000	-0.1349265992411765	0.023192360163710776	850000
chrX	105250000	105600000	0.08797545021428572	0.040927694406548434	350000
chrX	105600000	106650000	-0.10786267399999999	0.06343792633015007	1050000
chrX	106650000	107050000	0.014387332049999965	0.2489768076398363	400000
chrX	107050000	107500000	-0.05541288687777779	0.2384038199181446	450000
chrX	107500000	107700000	-0.13434008990000001	0.1145975443383356	200000
chrX	107700000	108000000	-0.33855464935	0.0006821282401091405	300000
chrX	108000000	108750000	-0.04741087690000001	0.2489768076398363	750000
chrX	108750000	108850000	0.0864626235	0.2384038199181446	100000
chrX	108850000	110100000	-0.042339766891999975	0.1855388813096862	1250000
chrX	110100000	110200000	0.10481035829999996	0.18178717598908595	100000
chrX	110200000	110550000	-0.012285660500000017	0.8441336971350614	350000
chrX	110550000	110600000	0.3577377587	0.0047748976807639835	50000
chrX	110600000	111050000	-0.05124588373333331	0.3806275579809004	450000
chrX	111050000	111750000	0.07183311988571428	0.029331514324693043	700000
chrX	111750000	112150000	-0.039532692650000006	0.48874488403819916	400000
chrX	112150000	113400000	0.03910414815600002	0.48669849931787174	1250000
chrX	113400000	114150000	-0.03365043474666665	0.5515006821282401	750000
chrX	114150000	114500000	-0.26590756139999994	0.010231923601637109	350000
chrX	114500000	114550000	0.04903496730000001	0.45770804911323326	50000
chrX	114550000	115000000	-0.06103529029999999	0.37755798090040926	450000
chrX	115000000	115550000	0.001959675900000013	0.9829467939972715	550000
chrX	115550000	116500000	-0.16604456308157894	0.004433833560709414	950000
chrX	116500000	117000000	0.07465611461	0.29433833560709416	500000
chrX	117000000	120000000	-0.1173647563383333	0.0023874488403819918	3000000
chrX	120000000	120050000	0.19792726590000004	0.04024556616643929	50000
chrX	120100000	120600000	0.15128267249000002	0.02694406548431105	500000
chrX	120600000	121150000	-0.06695200409272727	0.048431105047748974	550000
chrX	121150000	121650000	0.09642359147000001	0.10948158253751705	500000
chrX	121650000	122000000	-0.08373307493999997	0.247612551159618	350000
chrX	122000000	122550000	0.05530847516363634	0.24113233287858118	550000
chrX	122550000	123250000	-0.13784527941428568	0.008185538881309686	700000
chrX	123250000	123400000	0.3438100621	0.007162346521145975	150000
chrX	123400000	123850000	0.10268617966666668	0.0665075034106412	450000
chrX	123850000	125600000	-0.033315413225428574	0.04024556616643929	1750000
chrX	125600000	125900000	0.00178201297	0.9829467939972715	300000
chrX	125900000	126100000	-0.09189480203	0.22339699863574353	200000
chrX	126100000	126300000	0.046475006049999976	0.24249658935879945	200000
chrX	126300000	126400000	-0.010083716900000012	0.8622100954979536	100000
chrX	126400000	127000000	0.0959101635566667	0.07844474761255116	600000
chrX	127000000	127450000	-0.06934237798555556	0.24249658935879945	450000
chrX	127450000	128000000	0.030735196616363637	0.2810368349249659	550000
chrX	128000000	128050000	-0.12370184929999997	0.13744884038199182	50000
chrX	128050000	128650000	0.04641309320000003	0.4781718963165075	600000
chrX	128650000	129150000	-0.02574712642000001	0.6367667121418826	500000
chrX	129150000	129350000	0.022765081149999977	0.23192360163710776	200000
chrX	129350000	130050000	-0.05464250148571427	0.4024556616643929	700000
chrX	130050000	133300000	0.16336896944153848	0.008526603001364257	3250000
chrX	133300000	134250000	-0.046861642536842114	0.2100954979536153	950000
chrX	134300000	134350000	0.07529946970000001	0.28274215552523874	50000
chrX	134350000	134800000	-0.10401087509999996	0.18178717598908595	450000
chrX	134800000	134850000	0.07982987429999999	0.25852660300136426	50000
chrX	134900000	135000000	0.07982987429999999	0.25852660300136426	100000
chrX	135000000	136650000	-0.03664946320909091	0.20566166439290587	1650000
chrX	136650000	137400000	0.035779159639999995	0.3506139154160982	750000
chrX	137400000	137550000	-0.028991359100000003	0.6193724420190996	150000
chrX	137550000	137850000	0.01222464486666667	0.4273533424283765	300000
chrX	137850000	138300000	-0.0112035318	0.845156889495225	450000
chrX	138300000	138350000	0.03707233030000001	0.5521828103683493	50000
chrX	138350000	138550000	-0.07533984769999996	0.28274215552523874	200000
chrX	138550000	138800000	0.007418773000000045	0.9034788540245566	250000
chrX	138800000	138850000	0.31086704890000005	0.008185538881309686	50000
chrX	138850000	139800000	-0.09637179436842107	0.06753069577080491	950000
chrX	139800000	139850000	0.04400118439999995	0.48874488403819916	50000
chrX	139850000	140100000	-0.07094134429999999	0.3151432469304229	250000
chrX	140200000	140600000	-0.1005131363375	0.17939972714870395	400000
chrX	140650000	141400000	-0.18439024826000003	0.04024556616643929	750000
chrX	141400000	142850000	0.12768859048275866	0.02592087312414734	1450000
chrX	142850000	143150000	-0.05833400628333332	0.06343792633015007	300000
chrX	143150000	143200000	0.005873644000000011	0.9195088676671214	50000
chrX	143250000	143500000	0.028656491440000008	0.4918144611186903	250000
chrX	143550000	143750000	0.042408274800000006	0.4918144611186903	200000
chrX	143750000	144500000	-0.061128967146666664	0.17360163710777626	750000
chrX	144500000	145100000	0.07030785935166667	0.2810368349249659	600000
chrX	145100000	146900000	-0.0745079125941667	0.023874488403819918	1800000
chrX	146900000	146950000	0.2138092546	0.027285129604365622	50000
chrX	146950000	147100000	-0.039118145800000004	0.5330832196452933	150000
chrX	147100000	147150000	0.003036420900000003	0.9594133697135061	50000
chrX	147150000	147300000	-0.059032544600000014	0.3898362892223738	150000
chrX	147300000	147900000	0.010218310000000008	0.8622100954979536	600000
chrX	147900000	148900000	-0.03501695875000004	0.2271487039563438	1000000
chrX	148950000	149050000	-0.058114619500000075	0.4017735334242838	100000
chrX	149100000	150300000	-0.06864025052916668	0.008526603001364257	1200000
chrX	150300000	150800000	0.03161592502000003	0.4781718963165075	500000
chrX	150800000	150850000	-0.04496487119999998	0.48124147339699863	50000
chrX	150850000	151150000	0.19436593180000003	0.010231923601637109	300000
chrX	151150000	151750000	-0.04231473259999998	0.3328785811732606	600000
chrX	151750000	151800000	-0.6186223047999999	0.00034106412005457026	50000
chrX	151800000	151850000	0.05264206310000008	0.44099590723055937	50000
chrX	151900000	152250000	0.05264206310000008	0.44099590723055937	350000
chrX	152350000	152400000	0.05264206310000008	0.44099590723055937	50000
chrX	152400000	152650000	-0.014024603600000018	0.8226466575716235	250000
chrX	152650000	152850000	0.06857923497499999	0.2813778990450205	200000
chrX	152850000	152900000	-0.012802498100000004	0.8437926330150068	50000
chrX	152900000	153450000	0.06303289703636365	0.1364256480218281	550000
chrX	153500000	154050000	0.06647016072727273	0.06718963165075034	550000
chrX	154050000	154950000	-0.07061861990555557	0.2489768076398363	900000
